width 85
height 85
...........@....................@@.........@..@@@@..............@@@@...@..@..........
.................@.....@..@..............@......@@.........@.@..@@@@.................
.@@.@..@................@...............@...............@.........@@............@....
@@@@......@...@...........................@........@@..........@.................@...
@@@...@..@..........@.........@...@..@...............@...........@@.............@@...
@@@....@.......@.....@.....@...........@....@....................@....@...@.@....@@..
@@.......................@....@.................@.........@..........@...............
..........@.@....................@....@..@........@...@......@..........@@...........
......@.........@.....@.@...@..........@...............@.@.............@@.....@......
@...@....@.........@.........@...........@@....................@...@....@.........@..
@......@.....@.....................@@.....@......@.......@........@.@............@.@.
@........@..@...@.@..@...........@....@....@..........@......@..........@....@.......
..@.........................@.................@......@.@........@.........@..........
....@.@.........@..............@...@.@.....................@.@...@...@......@..@.@...
.......................@..@..................@.................@...@..@...........@..
.@@@.........@.@.@@...................@................................@.....@.......
.@......@...@....@.@...@.........@@@@...........@..@.......@............@.@..........
...................................@@..................@.........@...@...............
.......@.............@.......@...........................@..........@.......@...@....
...........@.............@......@......@...@........@..@..@..@.......................
..@.................................@........@........................@.@............
.............................@..@...........@..@..@..@...@@.....@...........@........
......@.....@...@....@..@....................................@.....@.....@...........
............................@...@......@..@..........................@..@............
..................@......@....@..@................@..............................@...
@.@..........@..................@............@.@...@.....@.@......@.....@...@........
@.....................@..@...@........@.....................@........................
........@...........@.............@..@.........@.......@............@...@.@..........
..............@.........@....@@....@.....@......@.........@......@...@.......@.....@.
...............@.@...@..@@..............@........@...@.....@................@..@.....
........@..@............@.......@@...@.....@...................@..@........@.........
...@...@.....@.................@...............@........@.......@..................@.
........@..@.......................................@...@...........@.@...@......@....
......@................@.@..@..............@....@............................@.......
.@.@...........@......................@......@.......@..@.@..@...@...@.....@.........
.......@..@......@..@.........@.@..@...@...........@...........................@.....
@@..@...@...@................................@...........@........@..................
@@...........@....@.........@..........@........@....@..........@..@.......@.........
.........@.............@.....................................@.........@.@...........
..@@......................@..........@........@.....@..........................@.....
................@...@...........@......@..........@.....@.@.@....@..@................
.@..........@.........@.@......................@................@................@...
...........................@..........@.@.@......@@...@....................@.........
..@...@.@......@....@..........@...........@............@...@....@......@.@..@.@.....
...@..............@.....@...@.......@..@.............................................
@.....................................@.@.@....@.......@...........@.@....@...@.@....
...@.......@.@...@.@..@.@...........................@........@@........@..........@..
@....@.........@..............@.......................@...................@........@.
..@..............@@@.....@.@......@....@.....@.....@...............@@........@.@.....
..@......@.......@@@@.............................@...................@..............
@.......@..............@.......@.........@..............@.....@.....@................
............@.............@................@................@.............@...@......
...@......@.................@......@@.......@...@....................................
.....................@...............@...@.......@..@..........@...................@.
...................@.......@..@..................@..............@.@.......@......@...
........@.................@.......@.......@.....@......@...........@...@.............
.@....@.....@......@..@......@.....@................@.@.@...@............@..@..@.....
.........@...@...................@@.........@...........................@.....@....@.
..@.....................@..............@..@...@......@....@..........................
............@...@.........@..@.....@................@.@.......@.@..@............@....
...@.......@......@.........@..@...........@................@...........@............
.@.....@..........@@...@...........@.................@...@.......@...................
.........@........@@.@....@...@...@.......@..@..........@......................@.....
........@.......@...........@.........@...........@...@.........@...@................
....@....@.@.............@...........@........@......................@...@.......@...
.........@.............@...............................@.@..@...............@........
................@..............@..........@.......@...@.......@...........@..@...@...
.......@......@.......@...@........@.........@......@................................
......@...........@.@.....................@........@...............@....@..@.........
..@............@...............@..@...............@.....@.@..@.................@.....
.............@.....................@...........@.......@...........@........@.......@
...........@...@......@.@...@.@.............@...@...@.....@.@.......@...@............
.......@.@........@.................@..@......................@.....@....@...........
........@....@...@....@.........@..........@......@..........................@.......
...@................@........@..............@....@...........@..........@..@.....@...
.....@.@...@.@........@..........@.@.@........@....@......@@.....@.@...@........@....
...@....................@.................................................@....@.....
...............@..@........@.@.....@.....@.@....@.....@........@.......@.............
.........@....@....@.@.........@.@.................@...........@....@...@.....@......
@....................................@...@...@.@.......@....@@............@....@.....
..@@........@.@..@..@..@.@..............@.................@......@..............@....
...@@.................@......@.............@...@.....@.........@....@..@....@........
.................................@....@.........@......@.....................@.....@.
.......@....@....@.................@.................................................
.......@.....@@@.......@..................@@@........................................
16
34 5 0
33 69 0
5 77 0
64 58 0
64 67 0
81 84 0
63 45 0
31 3 0
7 16 0
63 44 0
54 6 0
32 3 0
8 18 0
52 50 0
39 80 0
56 20 0

81 72 0
41 2 0
30 57 0
7 40 0
27 4 0
43 55 0
5 12 0
78 79 0
9 12 0
81 32 0
78 29 0
2 40 0
12 14 0
62 81 0
77 65 0
79 44 0
