width 20
height 20
@@@.@@....@@.@@.....
.....@..............
....................
...@.@............@.
......@........@@@@.
.......@.....@..@@@.
....@........@...@@.
.........@..........
.@.....@.......@.@..
..@.................
....................
.......@..@.........
.@................@.
...............@....
.....@..............
..@.................
........@..........@
@@@@@@@@@@@@.......@
@@@@@@@@@@@@@..@....
@@@@@@@@@@@@@@....@@
15
5 7 0
2 7 0
6 6 0
13 4 0
13 15 0
1 1 1
14 17 1
17 2 1
15 0 1
16 12 1
8 6 2
3 7 2
8 0 2
9 10 2
9 8 2

18 13 0
12 10 0
4 4 0
7 14 0
0 2 0
12 13 1
7 15 1
9 0 1
13 10 1
18 9 1
17 19 2
6 16 2
19 6 2
18 18 2
14 7 2
