width 20
height 20
@@@.................
@@@@..........@.....
.......@..@.@.......
...........@........
........@...........
....................
...@.@..............
........@....@......
................@...
...@...@......@.....
....................
.@....@.......@.....
....@...............
........@....@.....@
...@...............@
....@..@..@....@.@..
....................
...@..@..@..........
.@..............@...
@.....@....@@......@
15
8 19 0
7 8 0
9 19 0
3 16 0
9 14 0
6 6 1
5 15 1
4 18 1
13 19 1
7 10 1
2 6 2
11 8 2
15 8 2
5 14 2
5 13 2

19 0 0
17 14 0
15 5 0
18 5 0
15 7 0
11 6 1
5 0 1
14 16 1
10 6 1
7 19 1
3 5 2
12 11 2
0 17 2
13 18 2
5 13 2
