width 20
height 20
.@................@@
..................@@
...............@..@@
..@@.....@...@.....@
...............@....
....................
...@........@.......
@.@..@..............
.......@.@......@...
..............@..@..
...@....@..@........
....................
........@...........
....................
..@.....@..@.@....@.
..@.....@...........
.@....@.......@.....
...............@..@.
.................@@@
......@@.........@@@
15
8 8 0
2 1 0
11 0 0
0 4 0
2 2 0
9 15 1
8 17 1
1 2 1
13 18 1
17 5 1
9 5 2
4 5 2
18 15 2
6 18 2
14 17 2

17 7 0
18 10 0
8 1 0
7 4 0
3 11 0
9 15 1
18 13 1
1 1 1
12 7 1
5 1 1
19 17 2
1 4 2
16 15 2
3 0 2
10 15 2
