width 20
height 20
@@@@@@@@@@@@@@@@@@@@
@@@@@@@@@@@@@@@@@@@@
@@@@@..@@@@@@@@@@@@@
@@.@@@..@@@@@@@@@@@@
@..@@@.@.@@@@@@@@@@@
@@.........@@@@@@@@@
@..@.@.@.@@@@@@@@@@@
..@.@..@.@@@@@@@@@@@
@.@..@@...@@@@@@@@@@
..@@..@@.@@@@@@@@@@@
@....@@@@@@@@@@@@@@@
@.@@.@@@@@@@@@@@@@@@
....@@@.@@@@@@@@@@@@
.@@..@@..@@@@@@@@@@@
..@@@.@.@@@@@@@@@@@@
.@@@@...@@@@@@@@@@@@
..@@..@..@@@@@@@@@@@
.@@@.@..@@@@@@@@@@@@
.@@.@.@...@@@@@@@@@@
........@@@@@@@@@@@@
15
7 16 0
6 7 0
1 7 0
1 4 0
7 5 0
4 19 1
2 6 1
1 10 1
4 8 1
5 19 1
1 19 2
7 17 2
3 10 2
2 5 2
4 9 2

8 8 0
6 6 0
4 17 0
8 13 0
0 17 0
4 10 1
4 19 1
7 16 1
1 11 1
8 7 1
2 12 2
4 16 2
3 10 2
5 18 2
1 7 2
