width 20
height 20
@@@@@.@@@@@@@@@@@@@@
@@@@@..@@@@@@@@@@@@@
@@@@@@.@@@@@@@@@@@@@
@.@@....@@@@@@@@@@@@
@...@.@@@@@@@@@@@@@@
..@@@.@.@@@@@@@@@@@@
@.@......@@@@@@@@@@@
..@.@.@@.@@@@@@@@@@@
@.@..@.@..@@@@@@@@@@
@..@@@..@.@@@.@@@@@@
..@.@.@....@...@@@@@
@.......@.@@@.@@@@@@
@.@@.@.@....@.@@@@@@
..@.@@..@.@....@@@@@
.@@.@..@@@..@.@@@@@@
..@..@.@@@.@..@@@@@@
.@@@......@@@@@@@@@@
.@@..@.@@@@@@@@@@@@@
.@@@..@@@@@@@@@@@@@@
@....@@@@@@@@@@@@@@@
15
7 11 0
5 5 0
3 14 0
13 14 0
6 13 0
1 13 1
5 1 1
5 3 1
8 6 1
1 15 1
10 12 2
0 16 2
13 15 2
10 14 2
0 17 2

5 1 0
1 11 0
9 11 0
1 7 0
3 8 0
5 16 1
5 6 1
9 9 1
4 12 1
8 12 1
11 13 2
1 12 2
10 10 2
4 17 2
9 12 2
