width 20
height 20
@@@@@@@@@@@@@@@@@@@@
@@@@@@@@@@@@@@@@@@@@
@@@@@@@@@@@@@@@@@@@@
@@@..@@@@@@.@@@@@@@@
@@@.@.@@@@..@@@@@@@@
.@..@......@@@@@@@@@
..@...@.@.@...@@@@@@
.@.@@.@.@.@.@@@@@@.@
......@@....@@@@@...
@@@.@@..@.@.@@@@@@.@
@@@@...@@@..@@.@@...
@@@.@@..@.@......@.@
@.@.@..@....@@.@@@.@
......@.@.@..@......
@.@@.@...@..@..@@.@@
@@@@...@@@@.@@@...@@
@@@@.@.......@..@@@@
@@@..@@.@.@.@@@@@@@@
@@@@...@@..@@@@@@@@@
@@@@.@.@@.@@@@@@@@@@
15
3 17 0
0 5 0
5 5 0
17 10 0
14 10 0
19 10 1
11 3 1
11 10 1
13 6 1
7 6 1
9 9 2
6 18 2
7 17 2
3 9 2
10 8 2

1 6 0
11 6 0
12 6 0
9 16 0
7 5 0
7 7 1
18 8 1
7 9 1
5 10 1
4 16 1
9 5 2
11 12 2
6 15 2
14 13 2
7 14 2
