width 20
height 20
.@.@...@.@@@@@@@@@@@
....@.@....@@@@@@@@@
.@@@....@@@@@@.@@@@@
.....@@....@@...@@@@
.@.@@...@@@@@@.@.@@.
@..@@.@@@@@@@.......
@.@@@..@@.@.@.@@.@@.
..@@@.@.......@@.@..
@@..@..@.@@@.@@@@.@.
.@.@@.@@...@..@@@...
......@@@.@@@.@@@.@.
@@.@.@.@@..@.@.@@.@@
@@@.....@@@........@
@@@@.@.@.@.@.@@@.@..
@@@@@......@....@@.@
@@@@@@.@@@...@.@..@@
@@@@@@@@@@@@..@.@...
@@@@@@@@@@@@@.....@@
@@@@@@@@@@@@@@@@.@..
@@@@@@@@@@@@@@@@...@
15
8 9 0
16 17 0
13 16 0
6 0 0
18 7 0
14 2 1
13 12 1
17 5 1
16 18 1
12 8 1
0 7 2
19 16 2
12 16 2
19 10 2
4 10 2

6 4 0
12 16 0
1 10 0
12 14 0
9 10 0
2 3 1
8 9 1
11 15 1
14 5 1
13 10 1
10 13 2
17 16 2
3 1 2
6 0 2
5 12 2
