width 20
height 20
.@@@@@@@@@@@@@@@@@@@
..@@@@@@@@@@@@@@@@@@
@...@@@@@@@@@@@@@@@@
@.@.@@@@@@@@@@@@@@@@
...@@@@@@@@@@@@@@@@@
@@..@@@@.@@@@@@@@@@@
@..@.@...@@@@@@@@@@@
.@.....@..@@@@@@@@@@
.@.@.@.@@@@@@@@.@@@@
....@.....@@@.....@@
@@.@@@.@.@@@.@.@.@..
@....@@......@@..@.@
..@.@@.@@.@@..@@.@..
@..@......@@.@@....@
@.@@@.@.@.@@....@@.@
@@@@.@@.@@.@@.@@@@..
@@.........@@@@@@@@@
@@@.@.@.@.@@@@@@@@@@
@@@@...@@...@@@@@@@@
@@@@@.@@@@.@@@@@@@@@
15
7 16 0
4 13 0
1 13 0
12 14 0
2 13 0
19 10 1
2 16 1
3 11 1
4 8 1
4 15 1
4 7 2
5 17 2
1 11 2
5 7 2
5 14 2

8 11 0
10 16 0
9 9 0
9 11 0
3 12 0
1 13 1
0 0 1
3 9 1
15 9 1
5 13 1
4 6 2
9 17 2
1 2 2
8 16 2
5 14 2
