width 20
height 20
...@..@..@@......@..
@.@@@...@@.@.@@.@.@.
@..@.@@........@....
@.@.....@.@.@.@.@.@@
....@.@.@@.@........
.@.@@@.@....@.@.@.@@
.@@@@@.@.@@@..@@@..@
....@.......@@....@@
.@.@..@.@.@..@@.@@..
..@.@@...@..@.@.@..@
.@@...@@.@@......@.@
..@.@.@..@@.@.@.@...
@..@@.@.@.@..@.@@@.@
..@.@..@@.@.@@......
@.....@.......@@.@.@
@.@@@..@.@@.@@@@@..@
...@..@@.@..@.@@.@..
@.@..@@@..@......@.@
@@@@..@@.@@@.@.@....
@@@@.@@@@@@...@..@.@
6
1 1 0
16 19 0
3 7 0
8 0 0
3 11 0
0 9 0

19 8 0
5 15 0
15 4 0
15 8 0
9 7 0
16 10 0
