width 20
height 20
....................
................@...
........@..@..@.....
......@..@..........
....................
....@..@............
.........@..........
.....@........@.....
............@.......
..@....@........@..@
...........@.@.@....
..@.......@.........
..............@.....
@...................
@.........@..@......
@...@.............@.
@.......@......@....
@.............@.....
@@@....@..@.........
@@@.................
12
8 7 0
1 8 0
5 0 0
5 9 0
9 19 0
14 3 0
17 19 0
6 2 0
15 13 0
7 14 0
3 12 0
13 17 0

8 7 0
16 17 0
16 14 0
19 1 0
11 18 0
2 8 0
4 6 0
10 3 0
4 3 0
17 4 0
1 3 0
12 12 0
