width 20
height 20
......@.............
...@................
....................
....@.@@.......@....
.@..................
........@......@....
..........@.........
.@...@..@........@..
....................
......@...@...@.....
...............@....
.@..................
....@...............
............@..@....
.........@...@......
....@.@.............
@@........@......@..
......@........@....
................@...
...........@......@.
12
17 0 0
16 12 0
6 7 0
7 18 0
1 1 0
13 10 0
12 3 0
11 9 0
13 18 0
2 18 0
13 1 0
19 8 0

17 3 0
12 11 0
19 17 0
9 12 0
1 8 0
0 18 0
10 12 0
9 10 0
2 1 0
3 19 0
15 4 0
1 19 0
