width 20
height 20
....................
.........@..........
.............@......
......@...@.........
.@..................
......@....@..@.....
.....@.......@......
..@@....@.@......@..
........@.......@...
.......@...@........
....@...............
.........@....@.....
...@................
.........@..........
....................
.......@...@........
................@...
...@.@...@..........
....................
.@...........@......
12
0 1 0
14 3 0
14 10 0
4 6 0
10 13 0
12 7 0
14 2 0
18 13 0
5 19 0
3 15 0
0 18 0
13 3 0

13 8 0
2 17 0
0 1 0
17 12 0
1 0 0
1 10 0
1 18 0
11 6 0
1 15 0
19 0 0
8 4 0
19 12 0
