width 20
height 20
...@@@@.............
...@@@@.............
.......@....@..@....
....@.............@.
........@...........
..@...........@.@...
...........@........
.@...............@..
.......@...@..@.....
...@.........@......
.......@.........@.@
...@........@...@...
..............@@....
........@...........
.........@..........
.....@......@.......
.....@..............
....@...............
..@...@.@..@.......@
.............@......
12
3 6 0
7 12 0
7 0 0
13 4 0
19 0 0
1 2 0
16 18 0
3 4 0
1 16 0
10 13 0
8 7 0
10 8 0

3 12 0
4 12 0
8 1 0
16 17 0
13 15 0
0 19 0
17 9 0
12 6 0
6 9 0
11 12 0
6 8 0
10 8 0
