width 20
height 20
...@................
.........@...@..@...
..@..@......@.......
......@.............
.......@....@.......
..@.........@.......
.........@..@@...@..
.....@......@@@.....
............@.......
...@................
.......@...@.......@
..............@.@...
@................@..
@@...@.@............
.@......@.....@...@.
...@.....@..........
.....@..............
.......@.@.@........
@.............@.@...
@...................
4
2 17 0
9 12 0
12 0 0
0 5 0

3 19 0
9 7 0
12 0 0
3 12 0
