width 20
height 20
..............@@@...
....................
......@...@....@....
.....@...@.......@..
....................
.......@.....@...@..
......@.............
...@.....@..........
@@..@...@.....@..@..
...................@
.....@..........@..@
...............@....
...@................
..@...@.@...........
.....@.@.......@....
...........@.......@
@.............@.....
@..@.........@......
@...................
@@................@.
4
4 0 0
4 1 0
2 0 0
7 19 0

14 9 0
15 3 0
4 9 0
5 9 0
