width 8
height 8
@@@@@@..
@@@@....
........
..@..@..
........
........
..@...@.
........
2
5 7 0
2 4 1

5 7 0
2 5 1
