width 20
height 20
@@@@@@@@@@@@@@..@@@@
@@@@@@@@@@@@.@@.@@@@
@@@@@@@@@@@@......@@
@@@@@@@@@@..@@@.@@..
@@@@.@@.@.@.......@.
.@@..@......@.@@@.@.
....@@@@.@.@...@@...
@@@.@@.@.@@@.@@@@@.@
...........@...@@...
.@.@@.@.@.@.@.@@.@.@
..@....@....@@......
.@..@.@@@.@...@@.@.@
@@@.@...@@..@@@...@@
.@@@.@.@@@@..@@@.@@@
.@@@..@.@@..@@@@.@.@
..@@@...@..@.@@.....
.@.@@.@@..@@..@@@.@@
.........@@..@......
@.@.@.@@@@..@..@@.@@
@@...@@@@@@...@@@..@
5
3 10 0
0 17 0
18 8 1
3 7 1
11 17 2

13 4 0
7 14 0
6 17 1
15 12 1
17 18 2
