width 20
height 20
......@............@
................@...
...............@.@..
..................@@
...........@.@....@@
.......@.@.........@
.....@............@@
.@......@..........@
.....@.....@........
...@................
.........@......@...
.......@.......@....
.@.......@..@.......
.................@..
.........@..@.......
.......@............
................@...
..@...@.............
.......@.@..@.......
.................@..
15
6 19 0
10 18 0
8 17 0
11 18 0
6 2 0
3 6 1
18 5 1
14 4 1
17 4 1
7 2 1
5 10 2
17 18 2
1 19 2
18 7 2
13 2 2

16 14 0
5 12 0
17 5 0
13 3 0
9 16 0
19 17 1
0 15 1
1 16 1
3 18 1
19 19 1
17 1 2
16 17 2
0 18 2
2 3 2
16 15 2
