width 20
height 20
....................
...@................
...........@.@......
..@.........@....@..
...@............@...
..........@......@..
............@.....@.
.....@..............
....................
@.@......@..........
@....@.....@.@.@....
@.....@.............
................@.@.
..@.....@...........
....@.@.....@.@.....
........@.......@.@.
.@..................
....@..@..@.........
..............@@....
.............@@@....
11
1 7 0
11 8 0
18 8 0
0 13 0
4 11 1
3 18 1
17 6 1
18 1 1
15 2 2
7 7 2
6 2 2

19 15 0
0 0 0
19 7 0
7 4 0
11 12 1
19 1 1
1 18 1
1 6 1
19 3 2
7 3 2
19 18 2
