width 20
height 20
@@@......@..@@.@.@.@
@@..@.@.@.@.........
@@@.@.@.....@@@.@@@.
...@@.@.@.@.@@.@...@
.@....@@.@@....@@@.@
..@.@..@...@.@..@...
.@.@@@...@@.@.@...@@
...@@@@.@.......@...
@@@.@.@@.@@.@.@@@.@@
@...........@@...@@@
..@.@.@.@.@.@..@.@.@
@.@@.@.@@@.@@@.@....
@......@@@..@@@.@.@.
@.@.@.@.@.@..@....@.
@@@@....@.@.@.@.@@@@
..@.@.@..........@@@
@....@@.@@@.@.@.@.@.
..@@@@@..@.@@@@.....
@.@@.@.@...@....@@.@
.........@.@.@.@...@
6
11 13 0
0 6 0
14 18 1
13 7 1
12 7 2
14 19 2

0 10 0
11 15 0
7 15 1
16 3 1
7 13 2
15 15 2
