width 128
height 128
@@@@@@@@@@@@@@@@@@@@@@@@@@@@@@@@@@@@@@@@@@@@@@@@@@@@@@@@@@@@@@@@@@@@@@@@@@@@@@@@@@@@@@@@@@@@@@@@@@@@@@@@@@@@@@@@@@@@@@@@@@@@@@@@
@.......@.......@.....@.........@.......@...@.......@.....@.......@.....@.........@.@.......@.............@.......@.............
@.@@@@@.@.@@@@@.@.@.@.@@@@@@@.@.@@@.@@@.@.@@@@@@@.@.@.@.@.@.@@@@@@@.@@@@@.@@@@@.@.@.@.@@@@@.@.@.@@@.@@@@@@@.@@@@@@@.@@@@@@@@@@@@
@...@...@.@...@...@.@.@...@...@.@...@...@.....@.@.@.@.@.@...@...........@...@...@...@...@.@...@...@...........@.....@...@.......
@@@.@@@@@.@.@@@@@@@.@.@@@.@.@@@.@.@@@@@.@.@.@.@.@.@.@@@.@@@@@.@@@.@@@@@.@@@.@.@@@@@@@@@.@.@@@@@@@@@@@@@@@@@@@.@.@.@@@.@.@@@.@@@.
@...@...@...@.....@.@.......@...@.....@.@.@.@.....@.....@.......@...@...@...@.........@...@.@...@.............@.@...@.@...@.@...
@.@@@.@.@@@.@@@.@@@.@@@@@@@@@@@.@@@@@.@.@.@.@@@.@@@.@.@@@.@@@@@@@@@@@.@@@.@@@@@@@@@@@.@@@.@.@.@.@.@@@@@@@@@@@@@.@@@.@.@@@.@.@@@@
@.....@...@.@...@.@.........@.....@...@.@.@.@.@...@.@.@.@.........@.@.@...@.....@.@.@.......@.@.@.....@.........@...@...@.@.@...
@@@@@@@.@.@.@.@.@.@@@@@@@@@.@@@.@.@.@.@.@@@.@.@.@@@@@.@.@@@@@@@.@@@.@.@@@.@.@.@.@.@.@@@@@@@@@.@.@@@@@.@.@@@@@@@@@.@@@.@.@.@.@.@.
@.......@.@.@.@...@.....@.....@.@.@.@.@.@...@.@.@.........@...@.@.......@.@.@.@...@.@.....@...@.......@...@.....@.....@.@.@...@.
@.@@@@@@@@@.@.@@@.@@@.@@@.@@@@@@@.@.@.@.@.@@@.@.@@@@@@@@@@@.@.@.@.@@@@@@@.@@@.@@@.@.@.@@@.@.@@@.@@@@@@@@@.@.@@@@@.@@@@@.@.@@@@@.
@...........@.@.......@.@.@.@...@...@.@...@.........@.......@...@.......@...@.@.....@...@...@.@.....@...@.@...@.......@.@.......
@.@@@@@@@@@@@.@@@.@@@@@.@.@.@.@.@.@@@@@@@@@@@@@@@.@@@.@@@@@@@.@@@@@@@@@.@@@.@.@@@@@.@@@.@@@@@.@@@.@@@.@.@.@@@.@@@.@@@@@.@.@@@@@@
@.@...@.......@.@.@.........@.@.@.@.......@.....@...@...@...@.@.......@...@.@...@.....@...@...@...@...@.......@...@...@.@.@.....
@.@.@.@@@.@@@.@.@@@.@@@.@.@@@.@.@@@.@@@@@.@.@@@.@.@@@@@.@.@@@@@.@.@@@@@@@.@.@.@.@@@@@@@.@@@.@@@.@@@.@@@@@@@@@@@.@.@.@@@.@@@.@@@.
@...@...@.@.....@...@.@.@...@.@.@.....@.....@...@.@.....@.@.....@.@.......@.@.@.......@.@.........@...@.....@...@.@...@.@...@...
@.@@@@@.@.@@@@@@@.@@@.@@@.@@@.@@@.@@@@@@@@@@@.@@@@@@@.@@@.@.@@@.@@@.@@@@@@@.@.@@@@@@@.@.@@@@@@@@@@@.@@@.@@@.@.@@@@@@@.@.@.@@@.@@
@.@.@.@.@...@.....@.......@.....@.@.........@...........@.....@.@...........@.@...@...@.............@...@.@...@.....@.....@.....
@@@.@.@.@.@.@.@@@@@@@@@@@@@.@.@@@.@@@.@@@@@.@@@@@@@@@@@.@@@@@@@.@@@@@@@@@@@@@.@@@.@.@@@@@@@@@@@@@@@@@.@@@.@@@@@.@@@.@@@@@@@.@@@.
@.....@.@.@.@...............@...@.....@...@.....@...@.........@.....@.............@.@.@.........@...@.......@...@.........@...@.
@.@@@@@.@.@.@@@@@@@.@@@.@.@@@@@.@.@@@@@.@.@@@@@.@.@.@@@@@@@@@.@.@@@.@.@@@.@.@@@@@@@.@.@.@@@@@@@.@@@.@.@@@@@.@.@@@@@@@@@@@@@@@.@.
@...@...@.@.....@.@...@.@.@...@.@...@.@.@.....@...@.@...........@...@.@...@...@...@...........@.....@.@...@.....@.......@.....@.
@.@.@.@@@@@.@@@.@.@@@@@.@@@.@.@@@.@@@.@.@@@@@.@.@@@@@@@.@@@@@@@.@.@@@.@@@@@@@@@.@@@@@@@@@@@@@.@@@@@@@@@.@@@.@@@@@.@@@.@.@.@@@@@@
@.@.@...@.....@.....@.....@.@.....@...@.@.....@.@.....@...@.....@.@.......@...@...@.@.........@.............@...@.@...@...@.@.@.
@@@.@@@.@@@@@.@@@@@@@@@.@@@.@@@@@@@.@.@.@@@@@@@@@.@@@.@@@@@@@.@@@.@@@@@@@@@.@.@@@.@.@.@@@@@@@.@@@.@@@@@@@.@@@.@@@.@@@@@.@@@.@.@.
@...@...@...@.....@...@.......@.@...@.@.........@...@.....@...@.@...@.@...@.@...@.@.........@.@...@.....@.@...@.......@...@.....
@.@@@.@@@.@.@@@@@.@@@.@.@@@.@@@.@.@@@.@@@@@@@.@@@@@.@@@@@.@@@@@.@@@.@.@.@.@.@.@@@.@@@@@.@@@.@.@.@@@.@@@@@.@.@@@.@@@@@.@@@.@@@.@@
@.....@...@.........@...@.....@...@.....@...@.....@.....@.....@.........@...@...@.....@.@.@.@.@...@.....@.@.........@.@.....@...
@.@@@.@@@.@@@@@@@@@@@@@@@@@@@@@.@@@.@@@.@.@.@@@.@@@@@@@.@@@@@.@.@@@@@@@@@@@@@@@.@@@@@.@.@.@.@@@.@@@@@@@.@.@@@@@@@@@@@.@@@.@.@@@.
@.@.@...@.......@.........@.......@...@...@.@.....@...@...@...@...@...@.....@.........@...@.........@.....@...@.......@...@.@...
@.@.@@@.@@@@@@@.@.@@@@@@@.@.@@@.@@@@@.@@@.@.@.@.@@@.@.@@@.@.@@@.@@@.@.@@@@@.@@@@@@@@@@@@@@@@@@@@@@@@@@@@@@@.@.@.@@@.@.@@@.@.@@@.
@...@.@.........@...@.@...@.@.@.@...@.@...@...@...@.@.....@.@.@.@...@...@...@.........@...@.................@.@.@...@...@.@.....
@@@.@.@.@@@@@@@@@@@.@.@.@@@.@.@.@.@@@@@@@@@@@@@.@@@.@@@@@@@.@.@.@@@.@@@.@.@@@.@@@@@@@.@.@.@@@.@@@@@@@@@.@.@@@.@.@@@@@@@@@.@.@@@@
@.@...@.@.........@.@.@.....@.....@.@...@...@.@.@.....@...@.@.@.@.@...@...@...@.....@...@...@.@.......@.@...@.....@.....@.@...@.
@.@.@@@@@.@@@@@@@.@.@.@@@.@@@@@@@.@.@.@.@.@.@.@.@@@@@.@.@@@.@.@.@.@.@.@@@@@.@@@@@@@.@@@@@@@.@@@@@.@@@.@@@@@@@.@@@@@.@@@@@@@@@@@.
@...@...@...@...@...@...@.@.....@...@.@...@.@.....@.@.@.@.@.@...@.@.@.@.@...@...@.@.....@.......@...@.....@...@.............@...
@@@@@.@.@@@.@.@.@@@@@.@@@.@.@@@.@@@@@.@@@@@.@@@@@@@.@.@.@.@.@@@.@.@@@.@.@.@@@.@.@.@@@@@.@.@@@@@.@@@@@.@.@@@.@@@@@@@@@.@@@.@@@@@.
@.....@.@.....@...@.@.....@.@.@.......@.....@.........@...@...@.....@...@.@...@.@.......@.....@.......@...@.........@...@...@...
@@@.@@@.@@@@@.@.@.@.@.@@@@@.@.@@@@@@@@@.@@@@@.@@@@@@@@@.@@@@@.@@@@@@@@@.@.@.@@@.@.@@@@@@@@@@@.@@@@@.@@@.@@@@@.@@@@@.@@@@@.@.@@@.
@...@...@...@.@.@.@.....@...@.@...@.......@...@.............@.@.........@.@.@.....@.......@.@.@...@.@...@.....@.....@...@.@...@.
@.@@@.@@@.@@@@@.@.@.@@@@@.@@@.@.@.@.@@@@@.@@@.@.@@@@@@@@@@@.@.@.@@@@@@@@@.@.@.@@@.@.@@@.@@@.@.@.@.@@@@@.@.@@@.@.@@@@@@@.@.@@@.@.
@.@.............@.@.....@.@.....@.@...@.@...@.@.@.......@...@.@.......@.....@.@...@.@.@.@...@...@...@.@.@.@.@.@.........@...@...
@.@@@@@@@@@@@@@@@.@@@@@@@.@.@@@@@@@@@.@.@@@.@.@@@.@@@@@.@.@@@.@@@@@.@.@@@@@.@@@@@@@.@.@.@.@@@.@@@@@.@.@.@.@.@.@@@@@@@@@@@.@@@@@.
@...@...@.......@.......@.@...............@.@.....@.....@.......@...@...........@...@...@.....@.....@...@...@...@.@.........@...
@@@.@.@@@@@.@@@@@@@@@@@.@.@.@@@.@@@@@@@@@@@.@@@@@@@.@@@@@.@@@@@@@@@@@@@@@@@@@.@@@.@@@.@@@.@@@@@.@@@@@.@@@@@@@@@.@.@@@@@@@.@.@@@.
@...@...........@.@.....@.@.@.@.@.@.......@.......@.....@.......@...........@.@...@.@...@...@...@.....@.......@.........@.@.@...
@@@.@.@@@@@@@@@.@.@@@.@@@.@.@.@@@.@.@@@@@.@.@@@@@@@@@@@.@@@@@@@.@.@@@@@@@@@.@@@.@@@.@@@.@@@@@.@@@@@@@@@.@.@.@@@@@@@@@@@.@@@.@@@.
@...@.@.......@.......@...@.......@.....@...@.......@...@.....@.@.@.......@.....@...@...@.....@.........@.@.....@.......@...@.@.
@.@@@.@@@@@.@@@@@@@@@@@.@@@@@@@@@@@@@@@.@@@@@.@@@.@.@.@@@@@.@.@.@.@.@@@@@.@@@@@@@.@.@@@.@.@.@@@.@@@.@.@@@.@@@.@@@.@.@.@@@.@@@.@@
@.@.........@.........@.@.@.............@.....@.@.@.@.@...@.@.@.@.......@.@.......@.@.....@.@...@...@.@.@.@...@...@.@.@.@.......
@.@@@@@@@.@@@.@@@.@@@@@@@.@.@@@@@@@@@@@@@.@@@@@.@.@@@.@.@.@.@@@.@@@@@@@@@.@.@@@@@@@@@@@.@@@@@@@@@.@.@@@.@@@@@.@.@.@@@@@.@@@@@@@.
@.......@.....@.@.@...@...@.......@.......@.@...@.@...@.@...@...@.........@.....@.......@.........@...@.....@...@.@.......@.....
@@@@@@@.@@@@@@@.@.@.@.@@@.@@@@@@@.@@@@@.@@@.@.@.@.@.@@@.@@@.@@@.@.@@@.@@@@@@@@@.@.@@@@@@@.@@@@@@@@@@@.@@@.@.@@@@@.@@@.@@@@@.@@@@
@.......@.@.........@.@...@.........@.....@...@.@...@...@...@.@...@...@.........@.@.......@.....@...@.@...@.@...@...@.......@...
@.@@@@@@@.@@@@@.@@@@@.@.@@@.@.@@@@@.@.@@@@@@@@@.@@@@@.@@@@@@@.@.@@@@@@@.@@@@@@@@@@@.@.@.@@@.@@@.@.@.@.@.@@@.@.@.@@@.@@@@@.@.@.@@
@...........@...@...@.@.....@.@.....@...........@.....@.......@.@.......@...........@.@.....@...@.@.@.@.@.@.@.@...@.@.....@.....
@.@@@@@@@@@@@.@@@@@.@@@.@@@@@.@@@.@@@@@@@@@@@@@.@@@.@@@.@@@.@@@.@.@@@@@.@.@@@@@@@.@@@@@@@@@@@.@@@.@.@.@.@.@.@@@@@.@.@.@.@@@@@@@@
@...........@.@.....@.@.....@...@.........@.......@.......@.......@.....@.@.......@...........@...@.@.@.@.......@.@...@.@.......
@@@.@@@@@.@.@.@@@.@@@.@@@@@.@@@.@@@@@@@@@@@.@@@.@@@@@@@@@@@@@@@@@@@@@@@@@@@.@.@.@.@@@@@@@.@@@@@.@@@.@.@.@@@.@.@.@.@.@@@@@.@@@@@.
@.......@.@.@.....@.......@...@...........@.@.....@.....................@...@.@.@.@.....@...@.....@...@...@.@.@...@.......@...@.
@.@@@@@@@@@.@.@.@.@@@.@@@.@.@@@.@.@@@@@.@@@.@@@.@@@.@@@@@@@@@@@@@.@@@.@.@.@@@@@.@@@.@@@.@@@.@@@@@@@.@.@.@@@@@@@@@@@.@@@@@@@.@@@.
@.@.....@...@.@.@...@...@.@.@.@.@.@.....@.....@.@...@.....@.......@...@...@.@...@...@.@...@.......@.@.@.......@...@.....@.....@.
@.@.@@@.@@@.@.@@@@@.@.@@@.@.@.@@@@@.@.@@@@@@@.@@@@@.@.@@@.@.@@@@@@@.@@@@@@@.@.@.@.@.@.@@@.@@@@@@@.@.@.@@@.@.@@@.@.@.@@@.@@@@@.@.
@.@...@.....@.@...@.@.@.@.@.....@...@.....@.......@.@.@...@.@.@.....@...@.....@...@.@...@.....@...@.@...@.@.....@...@.@.@...@.@.
@.@@@.@@@@@@@@@.@.@@@.@.@.@@@@@@@.@.@.@@@.@.@@@@@.@.@@@.@.@.@.@.@@@@@.@@@.@.@@@.@@@.@.@@@@@.@.@@@@@.@@@.@@@.@.@@@@@@@.@.@.@.@.@.
@...@...........@.@.....@.........@.@...@.@.@.....@.....@.@.@.@...@.......@.@.@.@...@.....@.@...@...@.@...@.@.@...@...@...@.@...
@.@@@@@@@.@@@@@@@.@@@@@@@@@@@@@.@@@@@@@@@.@@@.@@@@@.@@@.@@@.@.@.@@@@@@@@@@@.@.@.@@@.@.@@@.@@@@@@@@@.@.@.@@@.@@@.@.@@@.@@@@@.@.@@
@.....@.@.@...@.@...........@.....@...@.@.@.........@...@...@...@.............@.@.@.@.@...@.......@...@...@.@...@.....@.@...@...
@@@.@@@.@@@@@.@.@@@@@@@.@@@@@.@@@.@.@.@.@@@@@.@.@@@@@.@.@.@.@@@.@.@@@@@@@@@@@@@.@.@.@@@@@.@.@@@@@@@@@.@.@@@@@.@@@@@.@.@.@@@@@@@.
@.@...@...........@...@...@...@.....@.@.....@.@.@.@.@.@.@.@.@...@...@.@.@.@.....@.........@...........@.@.....@...@.@...@.......
@.@.@.@@@@@.@.@@@.@.@.@@@.@.@.@@@.@@@@@.@@@@@.@.@.@.@@@.@.@.@@@.@@@.@.@.@.@@@@@@@@@@@@@@@@@@@@@@@@@@@@@.@.@@@@@.@.@.@@@.@@@.@@@@
@.@.@.......@.@.@...@.@.@...@...@...@.......@.@.@.......@.@.@.@...@.@.@...........@.....................@.@...@.@.....@...@.@...
@.@.@@@@@@@@@@@.@.@@@@@.@.@@@@@.@@@@@.@@@@@@@.@@@.@@@@@@@.@.@.@@@@@.@.@.@@@@@.@.@@@.@@@@@.@@@@@@@@@@@.@@@.@.@.@@@.@.@@@@@.@@@@@.
@.......@.......@.@.....@.....@.....@...........@.....@...@.@.....@.@.@...@...@.@.@.@...@.@.....@...@...@...@...@.@...@.....@...
@@@@@.@.@.@@@@@@@@@.@.@.@@@@@.@@@@@@@.@@@@@.@@@.@@@.@.@.@@@.@.@@@@@.@.@.@@@.@@@.@.@.@@@.@@@.@@@@@.@.@.@@@@@.@@@.@@@.@@@@@.@.@.@.
@.....@.@.@.........@.@.@...@.........@.@.@...@...@.@.@...@.@.....@.@...@...@.@...@...@.........@.@...@...@...@...@.@.@...@.@.@.
@@@.@@@@@.@.@@@@@@@@@@@.@.@@@@@@@@@.@@@.@.@@@@@@@.@.@.@.@@@.@.@@@.@.@@@@@.@.@.@@@.@@@.@@@@@.@@@@@.@.@.@.@.@@@@@.@@@.@.@@@@@.@.@@
@.@.@.....@.........@.....@...@.@.@.............@.@.@.@...@.@.@...@.....@.@.@...@...@...@.@.......@.@...@.......@.@.@.......@...
@.@.@@@@@.@@@@@@@.@@@@@@@@@@@.@.@.@@@@@@@@@@@@@@@.@.@@@.@@@@@.@.@@@@@@@@@.@.@@@.@@@@@.@.@.@.@@@@@@@.@@@@@@@@@@@@@.@.@@@@@@@.@@@.
@.@.........@.....@.....@...................@.@...@.@.....@...@...........@.@.........@.@.....@...@.@.......@.....@.@.....@.@...
@.@@@@@@@@@@@.@@@@@@@.@.@.@@@@@@@@@@@@@@@@@.@.@@@.@.@@@@@.@@@@@@@@@.@@@@@@@@@@@.@@@@@@@.@@@@@@@@@.@.@@@@@@@.@.@@@.@.@.@.@.@.@.@@
@.@...................@.@.................@.....@.@.@.@.@.....@...@...........@...@...@.....@.....@.....@...@.@...@...@.@.@...@.
@.@.@@@@@@@@@@@@@.@.@@@.@@@@@@@@@@@@@.@.@.@@@@@@@.@.@.@.@@@.@.@.@.@@@@@@@@@@@.@@@.@@@.@.@.@@@.@.@@@@@@@.@.@@@.@.@@@@@.@@@.@@@.@.
@.@.@...@.@...@.@.@.@...............@.@.@.........@...@...@.@.@.@.....@.........@.....@.@.@...@.@.....@.@...@.@.....@...@.@.....
@.@.@.@.@.@.@.@.@.@@@@@@@@@.@@@@@.@@@@@@@.@@@@@@@.@@@.@.@.@.@.@.@@@@@.@.@@@@@@@@@.@@@.@.@.@.@@@.@@@@@.@.@@@.@.@@@@@.@@@.@.@@@@@.
@.@...@.@...@...@...@.....@.@...........@.......@.@...@.@.@.@.@...@.....@.......@.@.@.@.@.....@.@...@.@.@.@.@...@.......@.....@.
@.@.@.@.@@@.@.@@@@@.@.@@@@@@@.@@@@@@@@@@@@@.@@@.@@@.@@@.@@@@@.@@@.@@@.@@@@@@@.@.@.@.@@@.@.@@@@@@@.@.@.@.@.@.@@@@@@@@@@@@@.@@@.@.
@...@.@...@.@.@...@.@.......@.............@.@...@...@.......@.@.@...@.@.......@.@.@.....@.@.......@.....@.......@.@.........@.@.
@@@.@.@@@.@.@.@@@.@.@.@@@@@.@@@@@@@@@@@.@@@@@.@@@@@.@.@@@@@.@.@.@@@.@.@@@.@.@@@@@.@@@@@@@@@.@@@@@@@@@@@@@@@.@@@@@.@@@@@@@@@@@.@@
@.@.@...@...@.....@.@.@.@.....@.....@...@.....@.....@.@.@...@.....@.@.....@.@...@.@.....@.......@.......@...........@...@.....@.
@.@.@@@.@@@@@@@@@.@.@@@.@.@.@@@.@@@@@.@@@.@@@@@.@@@@@.@.@.@.@@@@@.@.@@@@@@@@@.@.@@@.@.@@@@@.@@@.@@@.@@@.@.@@@@@.@@@@@.@.@.@.@@@.
@.....@.@...@.....@.@.....@.@...@.@.....@...@.@.@...@.@.@.@.@...@.@.......@...@...@.@.........@...@...@.@.....@.....@.@...@.....
@.@@@@@.@.@@@.@@@@@.@.@@@@@@@@@.@.@@@.@@@@@.@.@.@.@@@.@.@.@@@.@.@.@@@@@@@.@.@@@@@.@.@@@@@@@@@@@.@.@@@.@.@@@@@.@@@@@.@.@@@@@@@@@.
@...@...@.........@.@.@.........@.@...@.....@...@.......@.....@...@...@...@.@...@.....@.....@.@.@.@...@.@.........@...@.......@.
@.@.@@@.@@@.@.@@@@@.@.@.@@@@@.@.@.@.@@@.@@@@@@@.@.@@@.@.@@@@@@@@@@@.@@@.@@@.@.@.@@@@@@@.@.@@@.@.@.@.@.@.@@@.@@@.@@@.@@@@@@@@@.@@
@.@.@.....@.@.@.....@.....@...@.@.@.....@...@...@.@.@.@.....@.......@.......@.@...@...@.@.......@...@.@...@.@.@...@...@.....@...
@@@@@@@@@.@.@.@.@@@@@@@@@@@.@@@.@.@@@@@@@@@.@.@@@.@.@@@@@@@.@.@@@@@@@@@@@.@@@.@.@@@.@.@.@@@@@@@@@.@@@@@.@.@@@.@@@@@@@@@.@@@.@.@@
@.........@.@.@...@.........@...............@.@.....@.....@.@.........@...@...@.@...@.....@...@.@...@.@.@...........@...@...@...
@@@.@@@@@@@.@@@@@.@@@.@@@@@@@@@@@@@@@@@@@@@.@.@@@@@.@@@.@.@@@@@@@.@.@@@@@.@.@@@.@.@@@@@@@.@@@.@.@@@@@.@@@@@@@.@@@.@@@@@.@@@.@@@.
@.....@...@.@...@.@.........@...........@...@...@.....@.@.........@.@...@...@...@...@.@.....@.................@...@.....@.@...@.
@@@.@@@.@.@.@.@.@.@@@@@@@@@.@.@@@@@@@@@.@.@@@.@@@@@.@@@.@@@@@@@@@@@@@.@@@@@.@@@@@@@.@.@@@@@.@.@@@@@@@@@@@@@@@.@@@.@.@@@@@.@@@.@.
@...@...@.@.@.@.@.......@...@.@.......@.@...@...@.@.@...@.....@...@...@.@.@.@.....@.@...@...@.@.....@.......@...@.@.@.@.......@.
@.@.@@@.@@@.@.@@@@@@@@@.@.@.@.@@@@@@@.@.@@@@@.@@@.@.@@@.@.@@@.@.@.@.@.@.@.@@@.@@@.@.@.@@@@@.@.@.@.@@@.@@@@@@@@@@@.@.@.@@@.@@@@@.
@.@.@.....@.@.@.......@...@.@.........@.....@...@...@.....@.@...@.@.@.@.......@...@.@.....@.@...@.@.@.............@.@...@.@.....
@@@.@.@@@.@.@.@.@@@@@.@@@@@@@.@@@@@@@.@@@@@.@@@.@@@@@@@.@@@.@@@@@.@.@@@.@@@@@@@.@.@.@@@@@.@.@@@@@.@.@@@@@@@.@@@@@@@.@.@.@.@.@@@.
@...@...@.@.@.....@.........@...@...@...@...@.....@.@...@...@...@.@.......@.....@.@.@...@...@.@.@.@.......@.@.......@.@...@...@.
@@@.@@@@@.@.@@@.@@@.@@@@@@@@@@@@@.@.@.@@@.@@@.@@@@@.@.@@@.@@@.@.@.@@@@@@@@@.@@@@@.@.@@@.@@@@@.@.@.@@@.@@@.@.@@@.@@@@@.@@@@@@@@@.
@...@.....@...@.@.@...@...........@.@.@.....@.....@.@...@.....@.@...........@.....@...........@.....@...@.@...@.@.....@.........
@@@.@@@@@.@.@@@.@.@.@@@.@@@@@@@@@@@.@.@.@@@.@@@.@@@.@.@@@.@@@@@@@@@@@@@@@@@@@.@@@@@@@.@@@@@.@@@.@@@@@@@.@@@.@@@.@@@@@.@.@@@@@.@@
@...@...@.@...@.@...@...@.....@.....@.@...@.....@...@.@.......@.......@.....@.@.......@...@...@.@.......@...@.......@...@...@.@.
@.@@@.@.@.@@@.@@@.@@@@@.@@@.@.@@@.@@@.@@@@@@@@@@@.@@@.@@@@@.@.@.@@@@@.@.@@@.@@@.@@@@@@@.@@@.@@@.@@@@@.@.@.@@@.@@@@@.@@@@@@@.@.@.
@.@...@.@...@.@.@.@...@.....@...@...@.@...........@...@...@.@...@.....@...@.....@.......@...@.....@...@.@...@...@.........@.@...
@.@.@@@.@.@@@.@.@.@.@.@@@@@@@@@.@@@.@.@.@@@@@@@@@@@.@@@.@.@.@@@@@@@@@.@@@.@@@@@@@.@.@.@@@.@@@.@@@.@.@@@.@.@.@@@@@@@@@@@.@@@.@@@.
@.....@.@.....@.....@...@.......@.@...@.........@...@...@...@.......@.....@.@.@...@.@.@...@...@.@.@.@...@.@.@.....@...@.@.......
@@@@@@@.@.@@@@@.@@@@@.@.@.@@@@@@@.@@@@@.@@@.@@@.@.@@@.@@@@@@@@@@@.@@@@@@@@@.@.@.@@@.@.@.@@@.@.@.@.@.@@@@@.@.@.@.@@@.@@@.@.@@@@@@
@.......@...@.....@.@.@.@.@...@...@.......@...@.@.....@.............@.@.......@.@.@.@.@.@...@.@.@.@.......@...@.......@.@.......
@.@@@@@@@@@.@@@@@.@.@.@.@@@.@@@.@.@.@@@@@.@@@@@.@@@@@@@@@@@.@@@@@@@@@.@.@@@.@@@.@.@.@.@.@.@@@@@.@.@@@@@@@.@@@.@@@@@.@@@.@.@@@.@@
@...@.....@...@.....@.@.@.......@.@.@.@.....@.......@...................@.@.......@.@.@.@.......@.@.....@...@...@...@...@.@.....
@@@.@.@@@@@@@.@@@.@.@.@@@.@@@.@@@@@.@.@.@@@@@.@@@@@@@@@.@@@@@@@@@@@.@@@@@.@@@@@.@@@.@@@.@.@@@.@.@@@@@@@.@@@.@@@.@.@@@.@@@@@.@@@@
@...@...........@.@.@.....@.@.......@.@...@.@.........@.....@...@.@.....@.@...@.@.......@.@.@.@.@.....@...@...@.@.@.......@.@...
@@@.@.@@@@@@@@@@@@@.@@@@@@@.@@@@@.@@@.@@@.@.@@@@@@@@@.@@@.@@@.@@@.@@@@@.@.@.@.@.@@@@@@@@@@@.@@@.@@@.@@@@@.@@@.@.@.@@@@@@@.@.@.@@
@...@.@.@.....@...@.@.........@.@.....@...@.....@...@.....@.....@.....@.@.@.@...@.......@...@.........@.....@.@.@.........@.@...
@@@.@.@.@@@.@@@@@.@.@@@.@@@@@.@.@@@@@@@.@@@.@@@@@.@.@@@@@@@@@@@.@@@@@.@.@.@.@@@.@.@@@.@.@@@.@.@@@@@@@@@@@@@.@.@.@.@@@@@.@@@.@@@.
@.@.@.@.......@...@.@...@...@.@...@.....@.........@...................@...@.@.@.@.@.@.@.....@...@...........@.@.@.@...@...@...@.
@.@.@@@.@@@@@.@@@.@.@.@@@.@@@.@@@.@.@@@@@.@@@@@@@@@@@.@.@@@@@@@@@@@@@@@@@@@.@.@.@.@.@.@@@@@@@.@@@.@.@@@@@@@.@.@.@@@.@.@@@@@.@@@.
@...@...@...@...@.@.@...@.@...@...@...@.......@...@...@...@.@.......@.....@.@.@.@...@...@.....@...@...@...@.@.@.....@...@.@.@...
@@@.@@@@@.@.@@@.@.@.@@@.@.@.@@@.@.@.@@@@@@@@@@@.@.@.@@@@@@@.@.@@@@@.@.@.@@@.@.@.@@@.@@@.@.@@@@@.@@@@@@@.@.@@@.@@@@@@@@@.@.@.@.@.
@.........@.....@.......@.......@.@.............@.@...............@...@.....@...@...@.........@.........@.....@.........@.....@.
33
13 83 0
81 59 0
13 94 0
115 11 0
93 101 0
22 7 0
73 49 0
37 36 0
105 90 0
48 119 0
109 19 0
87 49 1
10 47 1
97 69 1
17 40 1
59 101 1
95 49 1
41 69 1
47 20 1
98 83 1
54 47 1
96 51 1
9 91 2
31 96 2
35 83 2
42 97 2
95 47 2
101 11 2
117 57 2
124 49 2
59 74 2
111 13 2
9 2 2

107 46 0
115 73 0
1 124 0
47 52 0
7 1 0
98 43 0
92 107 0
65 98 0
105 105 0
52 51 0
62 43 0
73 39 1
107 49 1
50 109 1
55 11 1
71 15 1
93 97 1
61 17 1
83 69 1
115 6 1
32 123 1
14 5 1
93 46 2
7 11 2
51 41 2
3 109 2
50 113 2
125 1 2
117 83 2
27 17 2
59 70 2
111 13 2
95 3 2
