width 20
height 20
.........@.......@..
@@..................
@@.......@..@.......
@@..................
......@.......@..@..
.........@...@......
...@..@...@@.....@..
....................
..............@.....
...................@
....................
.....@..@...........
..@...@........@....
....................
.......@............
...@................
...@..@.............
@...................
....@...............
@...................
4
3 0 0
15 11 0
7 18 1
15 3 2

19 17 0
9 8 0
18 17 1
4 13 2
