width 20
height 20
.............@@.....
...............@....
........@...........
..........@.@.......
.....@..............
@..........@...@....
....@...@...@....@@.
....................
....................
.@...............@.@
..@......@.@.......@
....@..............@
..............@..@..
....@....@..........
....@.......@.......
.........@.....@.@..
..............@.....
....................
........@...........
...@@..............@
4
3 4 0
18 1 0
7 19 1
2 15 2

19 18 0
3 14 0
11 6 1
6 16 2
