width 20
height 20
..............@.....
..............@.....
...@......@.........
.................@..
....@....@.@......@.
.......@............
..............@.....
.@.......@..........
@...................
@@@.........@...@...
@@...........@......
.........@.......@..
............@.......
..@.................
....................
..@.@..@...@........
....................
@.....@...........@@
..............@..@@.
.............@@.....
7
14 5 0
2 0 0
10 10 0
8 18 1
13 3 1
12 7 2
13 18 2

8 4 0
7 2 0
11 11 0
19 0 1
17 16 1
15 11 2
0 0 2
