width 20
height 20
..................@.
...@.....@..........
...........@........
.@..................
................@...
......@......@.@....
..@................@
@.......@.@...@....@
............@......@
...@.....@..........
..................@.
.....@..............
....@.....@......@..
..............@.....
@......@...@@.@.....
@@......@.....@.....
@...........@..@..@.
@@.....@............
@.........@..@......
@......@........@@..
7
18 13 0
18 6 0
4 6 0
6 16 1
0 0 1
14 6 2
13 4 2

5 4 0
4 8 0
19 19 0
7 2 1
6 2 1
18 11 2
13 6 2
