width 20
height 20
.......@@...@.......
............@.......
...........@........
....................
....................
...............@....
..@....@...@....@.@.
..............@.....
......@.............
....@..@.@..@.......
..@........@........
@..............@.@..
...........@........
......@..@..........
....................
........@......@....
....@.......@.......
.................@..
..................@.
........@@@.........
7
11 1 0
13 2 0
16 7 0
5 12 1
15 16 1
5 10 2
3 11 2

15 19 0
0 18 0
7 16 0
18 4 1
5 2 1
4 17 2
16 15 2
