width 20
height 20
....@...............
..............@.....
@......@............
..........@.........
............@.......
....@........@.@....
........@........@..
.@..................
..........@..@......
....@..@........@...
...................@
...@.......@.@......
................@...
..............@.....
..@.................
...............@.@..
............@.......
@@...@@.............
....@@@..........@..
....@@@@@@@.........
7
18 10 0
2 7 0
16 3 0
13 4 1
18 13 1
17 11 2
6 15 2

17 10 0
16 18 0
3 13 0
15 1 1
18 12 1
4 6 2
9 16 2
