width 20
height 20
@@@@@@.@..@@@@@.@.@@
@@@@.....@.@@@.....@
@@@.@.@@...@@.@@@.@@
@@......@@..@......@
@@@.@.@@@..@@.@@.@..
@@@@...@..@@...@.@.@
@@@@@.@@.@.@.@.@@@@@
@@@@@@........@@@@@@
@@@@@@@.@@.@.@..@@@@
@@@@@@@@@..@..@.@@@@
@@@@@@@@@@.@.@@..@@@
@@@@@@@@@@..@...@@@@
@@@@@@@@@@@.@.@...@@
@@@@@@@@@@@..@@@@..@
@@@@@@@@@@@@...@.@..
@@@@@@@@@@@@.@.....@
@@@@@@@@@@@..@.@.@@.
@@@@@@@@@@@.@.@.....
@@@@@@@@@@@@@...@@.@
@@@@@@@@@@@@@@@..@..
10
9 4 0
15 8 0
13 14 0
15 15 0
16 16 0
10 10 0
17 2 0
8 2 0
11 11 0
17 13 0

9 0 0
13 11 0
16 15 0
5 2 0
14 8 0
14 15 0
11 7 0
6 1 0
7 8 0
12 6 0
