width 20
height 20
@@@.@@@..@@@@@@@.@..
@@...@..@.@@@.@....@
@@@.@..@...@..@.@.@.
@@..@@...@@@@...@@..
@.@.@.@@.@.@.@@...@.
@.@.............@@..
...@@.@@.@@.@@@@@@.@
@.@.@.@.@@.@.@.@@...
.................@.@
@.@@.@.@@.@.@@@@...@
....@.@@@.@@@.@.@@..
@.@....@@..@.......@
@@..@.@@@@.@.@@.@@.@
@.@@..@.@...@..@....
...@@....@.@@@.@@@.@
@.@...@.@.@@@@......
...@@@@...@@@@@@.@.@
@.@.@.@.@@.@@@.@..@@
.............@...@@@
@.@.@.@.@@.@.@@.@@@@
3
1 19 0
1 16 1
16 1 2

1 14 0
5 18 1
6 1 2
