width 20
height 20
@...@......@@@@..@@@
@@.@.@.@@.@..@.@..@@
.@.@.@.@...@.....@@@
.....@@.@.@.@@.@@.@@
.@@@...............@
.@.@.@@.@@.@.@.@@@..
.@.....@.@.@@.@@@@.@
.@.@@.@...@.@..@@..@
.@.@.@@.@.@.@.@@.@..
@........@.........@
..@.@.@.@..@.@.@@@..
@.@@.@.@.@..@@@...@.
@..@.......@.@.@.@.@
..@..@@.@@.......@..
@.@@...@.@.@.@.@...@
@..@@.@...@.@.@..@@@
.@...@@@@.......@@@@
...@@@@@@@.@.@.@@@@@
.@..@@@@@@@...@.@@@@
..@.@@@@@@@@@....@@@
3
9 8 0
10 13 1
6 0 2

3 13 0
17 1 1
14 7 2
