width 20
height 20
@@@@@@@@@@@@@@..@@@@
@@@@@@@@@@@@@@@..@@@
@..@@@@@@@@@@.@.@.@@
..@.@@@@@@.@........
@.....@@@..@@.@.@.@.
..@.@..@@@..@@...@@.
@..@.@..@..@@.@.@..@
..@...@..@.@..@...@.
@.@.@...@....@.@@...
..@@.@.@@@.@...@.@.@
@....@..@.@@.@......
@@@@.@@@....@@.@.@.@
@.@......@.@@.@@@@..
..@.@.@@..@....@.@.@
@..@@.@..@.@@@.@...@
@.@.@@.@.@.......@.@
...........@.@.@.@@.
.@.@.@@@.@..@@@@@...
@...@.@@@..@.@.@.@.@
..@......@..........
3
16 7 0
19 19 1
18 8 2

15 2 0
5 7 1
7 6 2
