width 20
height 20
@@...@....@@......@@
@@................@.
....@..@..@.........
..@.................
...........@........
.@...@.@............
...............@....
....@........@......
@@.....@..@.@.....@@
@@.@.@...........@@@
@@@@.............@@@
..........@.....@@@@
..@.............@@@@
.......@...@...@....
...@..........@.....
.....@..............
....................
.......@.....@......
........@...........
.@@@................
4
13 3 0
3 13 0
14 17 0
5 11 0

19 15 0
16 8 0
12 18 0
19 1 0
