width 20
height 20
..................@.
.......@............
...@......@...@.....
..................@.
..@.................
....@@@..@......@...
@...@@@........@....
.......@@...........
....@..@..@.........
..@..............@..
............@.......
....................
........@.......@...
..@......@.@.@......
....@.@.............
.......@..@..@......
.@..................
..@.@.@..@..........
....................
................@...
4
13 5 0
17 4 0
13 2 0
12 1 0

0 19 0
0 18 0
4 11 0
11 0 0
