width 20
height 20
..@.................
......@.....@.......
....................
..................@.
@..@...@@...........
.....@..............
...@....@...........
.........@.....@....
....@.@...........@.
@..@.@..............
............@.......
.........@..........
................@...
.@.@.............@..
....@....@..........
......@.....@...@...
..@..@..@...........
...@........@.@...@.
.........@@.........
....@@@.............
4
14 16 0
17 8 0
16 11 0
4 11 0

5 4 0
5 3 0
8 7 0
7 10 0
