width 20
height 20
....................
.....@..............
..@.................
.........@....@.....
....@...............
.....@..@.@.@.......
.@..................
...@................
............@.......
...@............@..@
........@..@..@...@@
....@....@..........
.....@..........@...
...@.........@......
......@.......@.....
....@..@.....@..@.@.
.@..................
.....@..............
.......@............
....................
4
7 3 0
2 17 0
13 17 0
18 9 0

19 19 0
8 1 0
17 0 0
3 6 0
