width 20
height 20
@...................
@.......@...........
..@.................
.................@..
....@........@.@....
.........@..........
.........@..........
...@..........@.@...
.....@..............
.......@............
....................
...@................
......@....@@.@.....
...............@....
..@.......@.........
....@......@.....@..
.@.............@....
.....@......@.......
.......@............
....................
4
13 11 0
16 12 0
0 9 0
12 9 0

19 0 0
2 18 0
14 18 0
17 17 0
