width 20
height 20
@...............@...
....@...@...........
...@...@..@.........
....................
...................@
@...........@......@
.........@..........
.................@..
......@.............
...@...........@....
..@.@...............
.........@...@......
@..@...........@....
@.........@.....@...
....................
............@.@....@
.@......@........@.@
.......@..@.........
...................@
............@......@
4
15 11 0
4 8 0
10 18 0
0 9 0

11 5 0
1 19 0
16 2 0
16 16 0
