width 20
height 20
..................@@
..........@.......@@
.....@......@.....@@
..@...@..@.........@
.................@..
.........@...@.@....
.....@..............
.......@............
...@......@...@.....
....................
.....@.......@......
....................
........@.@...@.....
....................
.............@......
..@.....@...........
.............@......
..........@.......@.
....@...............
....@@@.............
1
10 5 0

4 17 0
