width 20
height 20
......@.........@...
@...................
@@...............@..
..............@.....
...@....@....@......
....@...........@...
...........@........
........@......@....
.@..................
@.......@.........@.
.......@............
....................
@..@....@...........
...........@........
....................
....@..@........@@@@
................@@@@
....@......@.......@
@...................
....................
1
18 4 0

4 0 0
