width 40
height 40
@.......@@@..........@..................
............................@@..........
....................................@...
....@..@...@@...@...........@.@.@...@...
.............@...........@..............
......@..@...........@...........@...@..
..........@............@................
...........@..@.@.@.......@.........@...
...@....................@...............
.......@.............................@..
.....@....@......................@......
..@......@........@.........@...........
@............@...............@....@@.@..
@.......@.@...@.....@.@.........@...@...
..................@........@............
.........@.......@.....@.....@......@...
....@.@.@...............................
...@................@..................@
............@....@........@...@.@......@
.....@..@......@..@....................@
....................@..................@
.......@.......@.@.......@.....@..@.....
...@.......@..........@..........@...@..
..............@.........................
.............@.....@....@...@.......@..@
.....@@.@...........@..................@
............@.....@.....@...@.....@.....
...@......................@..@........@.
....@......@.........@........@.........
............@..@...........@............
..@...@..............@.@....@......@....
.........@@.......@..............@......
...@................@...@.....@...@.....
...........@..@..@...@.........@........
..@....@.@..............@..@.....@......
...@........@@@...@.....................
.....@...........@........@.@@@.......@.
@..............@.....@..@...............
@@.......@..................@..@......@.
@@@@@...................................
4
31 28 0
14 27 0
19 21 1
9 22 2

0 3 0
24 1 0
28 4 1
16 24 2
