width 20
height 20
@..................@
.......@............
..........@.........
..@.......@.....@...
....................
@...................
.....@.@............
...@........@.@.@...
..@.......@.........
.........@..........
..........@@..@..@..
.....@..............
....................
....@....@@.......@.
.....@..............
....................
.....@.@....@...@...
@.........@.......@.
....................
....................
8
7 0 0
10 16 0
16 5 0
0 2 1
7 14 1
12 13 1
3 11 2
15 3 2

7 19 0
17 19 0
14 19 0
19 19 1
7 3 1
1 0 1
14 15 2
17 4 2
