width 20
height 20
...@@.@@@@@@@@@@..@.
.@.....@@@@@@@@@.@@.
@.@@.@.@.@@@@@@@....
@.@@@....@@@.@.@.@.@
...@@@@@.@@......@..
@.@.@@@.....@.@@@@@.
.....@@@.@@@@..@.@@@
.@@@..@..@.@.@...@@@
.@...@.@......@@.@@@
.@@@....@.@@.@@@@@@@
....@@@.@@@..@@@@@@@
.@.@@@@..@@@.@@@.@@@
@@.@@@.@.....@@@.@@@
...@...@@@.@...@..@@
@@..@@..@...@@.@.@@@
@@.@@@@..@.@........
........@@..@@@.@@.@
@.@.@.@..@@...@@.@.@
@@@@@@@@@@@@@..@....
@@@@@@@@@@@@@.@@.@.@
12
19 15 0
2 4 0
9 5 0
4 9 0
3 10 0
1 16 0
3 8 0
8 11 0
2 16 0
8 17 0
1 5 0
18 19 0

19 15 0
18 4 0
0 6 0
4 9 0
16 6 0
13 4 0
13 13 0
0 13 0
15 4 0
2 11 0
14 15 0
16 7 0
