width 20
height 20
@@@.@.......@@...@@@
@@....@@@.@@.@@.@@..
...@@.@@.@.@....@.@.
@.@@........@.@.....
..@@@@.@@@@...@.@.@.
@.@@@.@@.@@@.@@..@@.
@@.@......@.@.@.@@@.
@....@.@@........@.@
@@.@@.@.@@.@.@.@....
@@.@....@..@@..@@.@@
@...@@@.@.@.@@@@@@@@
@@.@@@.........@@@@@
@@....@@.@@.@@.@@@@@
@..@.@@@.@....@@@@@@
@.@...@@@@@.@@@@@@@@
@@..@@@..@@....@@@@@
@@@.....@@@@@.@@@@@@
@@@.@.@...@@@..@@@@@
@@@@@@@.@..@@.@@@@@@
@@@@@@@@@@.@@.@@@@@@
12
5 9 0
19 1 0
6 0 0
11 7 0
3 7 0
14 12 0
10 0 0
15 4 0
7 11 0
13 7 0
14 17 0
17 2 0

5 12 0
9 17 0
14 2 0
13 7 0
9 11 0
11 13 0
4 14 0
15 4 0
1 5 0
4 9 0
13 11 0
17 3 0
