width 20
height 20
@....@@@.@.@@@..@@@@
@@.@.@@.....@.@...@.
@@@@....@.@.....@...
@@@@@.@.@.@.@.@.@@.@
@@@@@@@@@.@@@@..@...
@@@@@@@....@@@@.@@@.
@@@@@@@@@@..@@..@@@@
@@@@@@@@@..@@@@@@.@.
@@@@@@@@@@..@@@@@...
@@@@@@@@@..@.@@@@@@.
@@@@@@@@.@.....@....
@@@@@@@@...@@.@.@@.@
@@@@@@@@@.@.........
@@@@@@@@@@@@@.@@.@.@
@@@@@@@@@.@.@..@..@@
@@@@@@@.......@@.@@@
@@@@@...@.@.@.@@.@@@
@@@@@@.@..@.@.@@@@@@
@@@@@@..@@@@....@@@@
@@@@@@.@@@@@@@.@@@@@
12
14 6 0
13 13 0
16 16 0
13 2 0
9 2 0
12 2 0
5 2 0
9 7 0
15 1 0
14 2 0
6 17 0
10 9 0

19 7 0
16 13 0
9 17 0
12 12 0
6 16 0
19 4 0
8 5 0
6 2 0
9 16 0
15 2 0
11 10 0
19 2 0
