width 20
height 20
@@@@@@@@@@@@@@@@@@@@
@@@@@@@@@@@@@@@@@@@@
@@@@@@@@@@@@@@@@@@@@
@@@@@@@@@@@@@@@@@@@@
@@@@@@@@@@@@@@@@@.@@
@@@@@@@@@@@@@@@@...@
@@@@@@@@@@@@@@@@@.@@
@@@@@@@@@@@@.@.@....
@@@@@@@@@.......@@.@
@@@@@@@@..@@.@@.....
@@@@@@@@@.@@@@@@.@.@
@@@@@@@@@..@.@.@@@..
@@@@@@@@.@.......@@@
@@@@@@@@...@@.@.@@@@
@@@@@@@@@.@@@@..@@@@
@@@@@@@@@@@@@@@..@@@
@@@@@@@@@@@@@@@.@.@@
@@@@@@@@@@@@@@@.@.@@
@@@@@@@@@@@@@......@
@@@@@@@@@@@@@@@@.@@@
12
17 16 0
9 10 0
15 13 0
12 9 0
16 18 0
10 13 0
9 13 0
16 9 0
8 9 0
12 12 0
8 12 0
13 18 0

18 7 0
13 18 0
9 14 0
17 16 0
16 19 0
18 18 0
16 9 0
8 9 0
9 13 0
8 13 0
16 7 0
18 8 0
