width 20
height 20
@@......@@@@@@@@@@@@
@@@@.@.@@@@@@@@@@@@@
@@@.@@..@.@@@@.@.@.@
@@@.@.@...@@@......@
@@@.....@@@@.@.@@.@.
@@..@@.@.@.....@....
@@@.@.@@...@@@.@.@@.
@@.......@...@.@...@
@..@.@.@..@.@@.@.@@@
@@@...@@@@..@@@@..@@
@@@@.@@@@@@...@..@@@
@@@@@@@@@@@@.@@.@@@@
@@@@@@@@@@@....@@@@@
@@@@@@@@@@..@.@@@@@@
@@@@@@@@@@@@@@@@@@@@
@@@@@@@@@@@@@@@@@@@@
@@@@@@@@@@@@@@@@@@@@
@@@@@@@@@@@@@@@@@@@@
@@@@@@@@@@@@@@@@@@@@
@@@@@@@@@@@@@@@@@@@@
8
6 4 0
10 5 0
14 7 0
4 10 1
17 9 1
3 4 1
5 6 2
17 5 2

18 5 0
6 0 0
16 5 0
4 10 1
14 7 1
16 3 1
6 7 2
14 12 2
