width 20
height 20
@@@@.@@@..@@@@@@@@@@
@@@@.@@..@@@@@@@@@@@
@@@....@.@@@@@@@@@@@
@@@@.@.@..@@@@@@@@@@
@@@@..@..@@@@@@@@@@@
.@@@.@.@..@@@.@@@@@@
..@@.@.@.@.@@..@.@@@
@.@@.....@.@@.@...@@
....@@.@........@.@@
@@.@@..@.@.@@.@@.@@@
....@@..@@@........@
@.@....@.@@@@.@@.@..
@@@@@@....@@@.@@@@@.
@@@@@..@.@@@.@@@..@.
@@@@@@.@@@@@..@@@.@.
@@@@@@@@@@@@@.......
@@@@.@@@@@.@..@.@.@.
@.....@@...@@..@@.@@
@@.@.@.@.@@.@.@.....
@@@...........@@@.@.
8
10 7 0
6 3 0
16 13 0
19 19 1
17 19 1
8 19 1
4 5 2
13 5 2

12 19 0
9 17 0
8 3 0
4 6 1
17 15 1
4 17 1
13 7 2
1 17 2
