width 20
height 20
@..@@@.............@
..@.@@@.@.@.@@@@.@..
@....@@@..@.@@..@..@
@@@.@.@.@.@.@..@..@@
@..........@@@..@..@
..@@.@.@.@....@...@@
@..@@@@@.@.@@@..@.@@
@.@@@@...@@@@@@@@@@@
@.@@...@@@.@@@@@.@@@
@..@.@.@@...@@@...@@
..@@.@...@.@.@.@.@@@
@...@@.@@@.....@.@@@
@.@..@..@@.@.@....@@
@@..@@.@..@.@@@@.@@@
@@@@.....@...@@@..@@
@@@.@@@@...@@..@.@@@
@@.......@@.@.@..@@@
@@@.@.@@.@......@.@@
@@...@@..@@.@.@....@
@@@@@@@@.....@..@@.@
8
17 5 0
11 16 0
12 0 0
9 13 1
5 14 1
1 10 1
17 2 2
16 18 2

10 11 0
10 0 0
12 10 0
4 8 1
2 18 1
13 3 1
10 12 2
14 4 2
