width 20
height 20
.....@.....@..@@...@
...................@
..@.@......@@.......
.......@..@.@......@
...................@
....................
........@..@......@.
....................
...@...@.......@....
....................
.......@...@....@...
..@.@.....@.........
...@..@..@..........
........@...........
...........@.......@
......@...@.........
....................
..............@.....
....................
@@@...@..@..........
9
5 3 0
12 10 0
13 5 0
12 4 0
6 10 0
6 18 0
18 15 0
9 14 0
1 6 0

18 19 0
14 9 0
6 6 0
11 5 0
19 15 0
9 18 0
0 13 0
19 12 0
18 2 0
