width 20
height 20
........@..@......@@
..............@.....
..@.................
...@...@............
............@.....@.
......@@..@...@.....
......@.@........@..
......@.......@.....
..........@.........
..@.@..........@....
....................
...@.....@..........
............@..@....
.........@..........
......@@.....@.....@
......@..@......@..@
...................@
........@.......@...
....................
..........@.......@.
14
9 8 0
1 17 0
5 19 0
9 7 0
0 7 0
6 17 0
15 4 0
16 18 0
19 2 0
18 6 0
2 19 0
15 13 0
10 17 0
15 2 0

8 7 0
5 13 0
3 14 0
9 7 0
5 9 0
6 1 0
13 8 0
12 14 0
8 8 0
16 4 0
2 17 0
12 9 0
6 4 0
7 0 0
