width 20
height 20
@...@.@@..@..@@..@@@
.@.@..@..@.@..@.@..@
.....@.@....@...@.@@
@.@@.....@@.@@@.@.@@
..@.@.@@.@.@.......@
.@..@@@@@@..@.@.@.@.
.@.@.@.@@.@....@....
...........@@.@@@.@.
.@.@.@@@@.@.@@...@..
@@@@@.@@@.@.@.@.@.@.
...@...@............
@.@.@.@@@.@.@.@.@.@@
.......@@@@@@@.@..@.
.@@.@.@...@@@@..@...
@....@@@.@.@@.@.@.@.
@@.@@...........@@..
@.....@.@.@@.@.@@.@.
@.@.@.@@.@@.@.@.@...
@..@@.............@.
..@@@@.@.@@.@@.@@..@
10
18 6 0
3 13 0
15 17 0
11 15 0
4 8 1
1 16 1
13 14 1
0 5 2
9 15 2
11 17 2

6 18 0
15 10 0
19 13 0
11 2 0
1 14 1
19 17 1
9 16 1
19 12 2
19 15 2
11 18 2
