width 20
height 20
@@@@@@@@@@@@@@@@@@@@
@@@@@@@@@@@@@@@@@@@@
@@@@@@@@@@@@@@@@@@@@
@@@@@@@@@@@@@@@@@@@@
@@@@@@@@@@@@@@@@@@@@
@@@@@@@@@@@@@@@@@@@@
@@@@@@@@@@@@@@@@@@@@
@@@@@@@@@@@@@@@@@@@@
@@@.@@@@@@@@@@@@@@@@
@@...@@@@@@@@@@@@@@@
@.@.@.@@@@@@@@@@@@@@
.......@@@@@@@@@@@@@
@.@.@.@@@@@@@@.@@@.@
@@@@...@@@@@@...@...
@@@.@.@.@@@@@@.@.@.@
.@..@....@@@@.......
...@.@@.@.@@.@.@.@.@
@@.............@..@@
@.@.@@.@@.@.@.@@.@.@
......@@@@...@@.....
10
14 14 0
3 10 0
9 17 0
3 9 0
3 17 1
0 11 1
14 15 1
6 17 2
15 13 2
16 17 2

9 16 0
16 15 0
16 17 0
3 9 0
18 19 1
5 10 1
8 17 1
3 19 2
0 19 2
14 14 2
