width 20
height 20
@@@@@@@@@@....@.@@@@
@@@@@@@@@@@@.@...@.@
@@@@@@@@@@.....@@@..
@@@@@@@@@@@@.@.....@
@@@@@@@@@@@@@.@@.@..
@@.@@@@@@@@@...@@..@
@....@@@@@..@.@.@.@.
..@@.@@@@@@.........
@.@@.@@@.@.@@.@.@.@.
@@.@..@....@.@.@...@
@@...@.@.@.......@..
@@.@......@.@.@.@.@.
@@.@.@.@.@@@.@.@....
....@..@...@.@.@@.@.
@.@..@.@.@.@.......@
@@..@.@.@@.@.@.@@.@@
@@@.....@.@.@.@.@.@@
@@@@@.@...@.@....@.@
@@@@@@.@@.@.@.@.@@..
@@@@@.........@....@
10
12 2 0
10 0 0
12 9 0
3 6 0
7 17 1
18 18 1
18 4 1
19 13 2
12 14 2
15 14 2

4 6 0
8 19 0
10 19 0
3 16 0
15 1 1
8 8 1
15 7 1
19 13 2
7 16 2
18 4 2
