width 20
height 20
.@..........@..@@.@@
......@...........@@
...@.@.@......@.....
............@......@
.......@......@.@..@
..@........@......@.
....................
..@.@.....@....@.@..
.............@......
...@................
.@.@.......@.@..@...
..@@.@..........@@..
.@.....@............
@...........@....@..
......@..@..........
....................
...@....@....@......
....................
.......@...@...@....
@.....@@............
1
11 16 0

12 4 0
