width 40
height 40
.........@...@..........................
..........................@.........@...
........@...@...........@..@............
..........@..................@.......@..
...@............@...@......@.....@......
............@..@...@....................
...@..@.................................
.......@.........@...@......@......@....
........@......@........@@..............
.@........@........@.........@..........
.....@.....@..................@.........
......@.................................
....@.....@..@.....@......@.......@.....
.......................@....@.@....@....
...@...@...@.@...@......................
....................@...........@.......
....................................@...
.........@...@..@..@.@...@..@...........
....@.....@............@.......@.......@
...........@..................@.@.......
...@.@..@..........@.................@..
............@.@..@..@....@..............
....@.....@............@......@.........
................@.................@.....
............@................@..@..@.@..
.@........@..@..@.@...@.................
.................@..........@.@.........
.@....@...@.............................
....@......@.@.@........@..@...@.....@..
..........@.....@.........@.............
...............@..@............@.....@..
........@....................@......@...
.@..@....@...@.@..@.....@.@.....@.......
....@.....@...........@........@........
@@@@..............@.@...................
@@@...@..@.....@..........@......@..@...
@@@..........@.......@.....@..@.........
.@..........@.........@.....@..@........
........@........@...............@......
......@............................@@...
67
9 28 0
28 12 0
7 19 0
39 3 0
13 16 0
16 6 0
9 9 0
15 33 0
12 10 0
22 17 0
21 1 0
29 27 0
34 9 0
20 9 0
35 29 0
36 8 0
31 29 0
15 36 0
33 6 0
17 32 0
31 10 0
30 25 0
6 0 0
37 16 0
39 22 0
39 10 0
38 5 0
30 17 0
16 30 0
36 9 0
17 33 0
14 26 0
18 35 0
35 5 0
10 4 0
0 22 0
37 35 0
7 20 0
39 34 0
10 37 0
0 5 0
8 26 0
31 25 0
36 25 0
32 21 0
2 29 0
1 33 0
29 15 0
14 7 0
28 27 0
26 14 0
8 36 0
7 32 0
6 34 0
33 31 0
8 9 0
37 33 0
2 8 0
4 27 0
10 31 0
0 2 0
37 32 0
38 27 0
11 5 0
14 3 0
15 38 0
8 21 0

36 4 0
3 19 0
7 10 0
21 38 0
21 12 0
24 24 0
33 5 0
3 8 0
33 33 0
21 13 0
28 1 0
27 37 0
32 7 0
10 2 0
26 27 0
36 11 0
1 3 0
15 37 0
20 14 0
37 8 0
12 26 0
12 10 0
20 3 0
3 15 0
1 0 0
10 1 0
16 26 0
31 24 0
14 17 0
20 18 0
25 26 0
12 30 0
6 21 0
34 6 0
22 29 0
24 36 0
35 33 0
15 16 0
29 16 0
25 38 0
17 29 0
25 12 0
26 19 0
30 21 0
31 36 0
34 3 0
29 35 0
28 10 0
13 10 0
12 27 0
9 22 0
1 39 0
21 2 0
39 0 0
26 26 0
39 5 0
7 32 0
6 0 0
9 16 0
39 11 0
1 11 0
18 2 0
26 23 0
27 26 0
27 18 0
2 17 0
28 15 0
