width 20
height 20
..............@.....
.........@..........
..@......@.....@....
...@................
.....@..........@...
.....@..............
........@......@....
..@...@.............
.....@...@..........
...@.......@.....@..
.@..@.@.@....@......
............@.......
.....@..........@...
.......@.......@....
....................
.............@.....@
..................@@
..............@...@@
...@........@..@....
...@...............@
14
3 1 0
16 2 0
14 3 0
11 19 0
9 18 0
19 13 1
0 8 1
12 7 1
4 17 1
0 1 1
1 11 2
4 7 2
3 5 2
16 0 2

16 19 0
1 9 0
19 6 0
7 17 0
9 18 0
0 6 1
6 18 1
9 3 1
19 12 1
10 0 1
1 11 2
2 18 2
9 19 2
13 9 2
