width 20
height 20
@@@@@@@@@@@@@@@@@@@@
@@@@@@@@@@.@@@@.@@@@
@@@@@@@@@...@....@@@
@@@@@@@@@@@...@@.@@@
@@@@@@@@@@@@.@@..@@@
@@@@@@@@@@@@...@.@@@
@@@@@@@@@@@@@@@@.@@@
@@@@@@@@@@@@@@.@..@@
@@@@@@@@@@@@@....@@@
@@@@@@@@@@@@@.@@.@.@
@@@@@@@@@@@@@...@...
@@@@@@@@@@@@@@.@@.@@
@@@@@@@@@@@@@@....@.
@@@@@@@@@@@@@@@.@...
@@@@@@@@@@@@@@..@.@.
@@@@@@@@@@@@@@@.@@..
@@@@@@@@@@@@@@..@@@.
@@@@@@@@@@@@...@@@@@
@@@@@@@@@@@@@@..@@@@
@@@@@@@@@@@....@@@@@
3
16 2 0
16 12 1
11 2 2

16 2 0
15 18 1
14 14 2
