width 20
height 20
@..............@....
@...................
..@.................
....@..@.@.....@....
....................
.......@............
......@...........@.
...@................
@.......@...........
..@..@...@...@...@..
..........@.........
....................
@...@...............
........@.@.....@...
.......@...@........
....................
.......@...@....@...
............@.......
.........@.........@
..@@...............@
4
7 13 0
15 13 0
11 17 1
17 5 2

9 12 0
10 12 0
7 17 1
2 7 2
