width 20
height 20
@...................
....................
...@.@....@@..@.....
.........@@@........
.@@.......@@..@.....
.@....@........@....
...@@@..@...........
....................
.........@.@........
......@.........@...
...............@....
@...........@.......
.@...@..............
.......@...........@
...@.......@...@.@@@
.................@@@
....@...@....@.....@
..@.......@@........
....................
...............@....
4
2 3 0
17 13 0
0 6 1
15 17 2

19 18 0
17 11 0
1 2 1
11 19 2
