width 20
height 20
@@@@..........@.....
@@@@................
@....@.......@..@...
@....@@.@.....@.....
...........@........
.........@........@.
........@...@@.@....
......@...........@.
...............@....
@..@.@..........@...
....................
...........@.@..@...
....................
..@....@....@.......
....................
...............@..@.
.......@..........@.
.@..@...............
........@..@........
....................
4
13 16 0
14 4 0
6 15 1
2 7 2

12 17 0
17 6 0
16 10 1
1 7 2
