width 20
height 20
@@@@@@@@@@@@@@@@@@@@
@@@@@@@@@@@@@@@@@@@@
@@@...@@@@@@@@@@@@@@
@@@@@.@@@@@@@@@@@@@@
@@.....@@@@@@@.@@@@@
@@@@@@.@@@@@@@..@@@@
@@@@.....@@@@..@@@@@
@@@@.@.@...@.@.@@@@@
@....@@..@.@....@@@@
@@@.@@@@..@.@.@@@@@@
@@@@@@@@@......@@@@@
@@@@@@...@.@.@@@@@@@
@@@@@@@@.@@@.@@@@@@@
@@@@@@@@.....@@@@@@@
@@@@@@@@@.@.@@@@@@@.
@@@@@@@@@@...@@.@...
@@@@@@@@@@@.@.@.@.@@
@@@@@@@@@@@........@
@@@@@@@@@@@@.@.@@@..
@@@@@@@@@@@@@....@@.
19
15 19 0
7 6 0
8 6 0
3 8 0
13 9 0
4 7 0
18 18 0
10 13 1
11 10 1
12 8 1
2 8 1
11 15 1
5 4 1
18 17 2
16 17 2
12 7 2
15 5 2
12 13 2
1 8 2

12 8 0
9 7 0
7 6 0
9 14 0
13 16 0
19 18 0
6 4 0
8 13 1
6 5 1
12 18 1
19 14 1
4 4 1
13 8 1
12 11 2
2 8 2
5 4 2
8 9 2
12 7 2
5 6 2
