width 20
height 20
...................@
..@.@...............
....@......@....@...
...............@....
..........@.........
........@...@.....@.
.............@......
......@..........@..
.......@..@.........
....................
....@....@......@...
.........@.........@
...............@.@..
...........@........
......@.............
........@...@.......
...........@....@...
...@................
..............@.....
............@@......
3
15 18 0
1 13 1
7 18 2

0 6 0
1 14 1
6 12 2
