width 20
height 20
....................
..............@.....
...........@........
.............@......
....@.@.............
........@......@.@..
..........@..@......
...@.@..........@...
..........@.........
......@.....@..@....
................@..@
....@.......@.......
..@.................
...........@........
......@..@......@...
....@...............
.......@..@.@.....@.
.........@.....@....
..@.................
@.................@@
13
4 2 0
15 14 0
9 9 0
6 7 0
7 7 0
4 6 1
15 13 1
9 8 1
10 5 1
6 11 2
14 3 2
13 15 2
11 5 2

0 18 0
11 16 0
3 15 0
7 15 0
9 13 0
4 5 1
13 19 1
4 0 1
19 16 1
5 11 2
9 9 2
19 4 2
15 13 2
