width 20
height 20
@@@..@..............
@@@..@@.....@.......
..............@.....
....................
.......@.@......@...
.....@...........@..
.....@@.......@...@.
......@....@........
...........@...@....
...........@@.......
...@...@....@.@..@..
....................
.....@............@.
.@..................
....................
.......@...@.@......
..............@.....
......@..@..........
...@.....@@....@....
..........@......@..
13
7 13 0
17 15 0
19 4 0
9 15 0
5 19 0
14 11 1
16 3 1
19 3 1
9 19 1
17 18 2
1 16 2
2 4 2
12 0 2

8 10 0
1 2 0
1 17 0
15 10 0
18 0 0
13 7 1
3 19 1
17 1 1
18 14 1
7 6 2
14 7 2
18 15 2
10 2 2
