width 20
height 20
..@@@@@@...@..@@@@..
@.@@@@@.@.@.@..@@@.@
..@.@@........@@@...
@.@..@.@.@.@@@@..@.@
....@..@.@@@.@.@.@..
@.@@..@.@.@......@.@
..@.@......@.@.@....
@.....@.@.@@@..@.@.@
..@.@.@@@..@@@.@@...
@..@.@@.@@@@@@.@..@@
..@.....@..@....@...
@.@@@.@.@.@.@@.@.@.@
..@.@@.........@..@.
@...@.@.@@.@@.@..@..
@.@...@.@@@...@.@.@.
.@@.@.....@.@.......
...@..@@.@@..@.@.@@.
.@@@.@@..@.@@.@..@..
.@@.@.@@....@...@@@.
.........@.@@.@.@@..
6
9 15 0
18 5 0
7 19 0
0 8 0
19 8 0
19 17 0

15 10 0
13 12 0
1 10 0
1 5 0
5 6 0
17 9 0
