width 20
height 20
......@@@@@@@.@@@@@@
@@.@.@.@@@@@.....@@@
@@@.....@@@@.@.@.@@@
.@.@@@@.@@@@@..@.@@@
.........@@.@.@...@@
.@.@.@.@.@@..@@@@..@
..@@..@..@..@.@...@.
.@@.@..@.@@.@.@.@...
....@@@.@@.....@.@.@
.@.@.....@@@.@@.....
.@@.@@@.@@@....@.@.@
........@@.@@.@@@..@
@.@.@@@.@...@.@@@@..
@@@.@@@@.@@...@@@@@.
.....@@.....@@@@@.@.
@@.@....@.@.........
.@..@.@@...@.@.@.@@.
.@.@@@@@@@@..@@@@@@@
....@.@.@..@...@@@@@
@.@......@...@@@@@@@
6
11 10 0
7 15 0
8 5 0
14 18 0
16 8 0
6 2 0

16 2 0
4 1 0
17 9 0
3 2 0
5 0 0
19 13 0
