width 20
height 20
............@...@...
.............@......
....................
.........@...@......
.................@..
....@...........@...
......@.............
...@............@...
...@@....@..........
......@..........@..
....................
.......@........@...
.@........@..@.@....
....@...@...........
.....@..............
.@....@.@...........
...........@........
..........@...@.....
....................
....................
16
13 4 0
14 11 0
7 6 0
1 13 0
19 6 0
12 7 0
9 0 1
5 8 1
3 16 1
5 2 1
18 13 1
11 6 2
19 11 2
15 14 2
0 16 2
13 2 2

11 9 0
3 12 0
9 15 0
10 5 0
3 9 0
15 14 0
10 3 1
19 9 1
19 0 1
18 11 1
14 7 1
15 15 2
0 1 2
10 1 2
16 9 2
9 19 2
