width 20
height 20
...@@@..@@@@@@@@@@@@
@.@.@@.@.@.@@@@@@@@@
...........@@@@@@@@@
.@.@.@.@.@.@@@@@@@@@
@@@...@@@...@@@@@@@@
.@..@.@@..@@@@@@@@@@
..@.@@.@@.....@@@@@@
.@@@......@.@..@@@@@
..@@@@.@.@..@.@.@@@@
.@......@..@.....@@@
...@.@.@@@.@@.@.@@@@
@@.@@@@@@@@....@@@@@
...@.@.@@@@.@.@@@@@@
.@.@.@.@@@@@@@@@@@@@
.@@.....@@@@@@@@@@@@
.@@.@.@@.@@@@@@@@@@@
....@.....@@@@@@@@@@
.@.@@.@@.@.@.@@@@@@@
..@@.@.......@@@@@@@
@@@....@.@.@...@@@@@
14
5 5 0
12 17 0
7 9 0
4 19 0
8 16 0
8 19 0
3 1 0
13 12 0
10 1 0
5 9 0
4 13 0
6 2 0
13 9 0
9 6 0

5 19 0
8 2 0
6 14 0
9 6 0
8 16 0
2 16 0
3 16 0
14 9 0
10 1 0
7 7 0
13 8 0
8 5 0
10 18 0
6 18 0
