width 20
height 20
@@@@@...@.@.@@.@@@@@
@@@..@.@........@@.@
@@@@.....@.@@.@.@...
@@@@.@.@.@@..@@...@@
@@@@.@@@@@@@....@@.@
@@@.....@.@.@@@....@
....@@.@.....@@.@.@@
.@@.@..@@@.@...@@@@@
@@.@.@.@.@@.@.@@@@@@
.......@.@@....@@@@@
.@.@.@....@@@.@.@.@@
@@..@@@@@@........@@
@@.@@@..@.@.@@.@.@@@
@...@.@.....@@@@@@@@
..@...@.@.@@@@@@@@@@
@.@.@.@..@@@@@@@@@@@
@..@....@@@@@@@@@@@@
@.@@@@.@@@@@@@@@@@@@
@@@@.....@@@@@@@@@@@
@@@..@.@@@@@@@@@@@@@
14
5 16 0
4 19 0
14 11 0
2 12 0
5 5 0
3 1 0
14 0 0
18 1 0
16 5 0
15 11 0
2 10 0
6 10 0
14 4 0
6 18 0

16 3 0
2 11 0
11 12 0
6 2 0
7 15 0
6 5 0
17 5 0
2 8 0
10 2 0
3 15 0
15 10 0
8 6 0
18 4 0
10 1 0
