width 20
height 20
@@@@@@@@@@.@@@@@@@@@
@@@@@@@@@..@@@@@@@@@
@@@@@@@@@@.@@@@@@@@@
@@@@@@@@@...@@@@@@@@
@@@@@@@@..@@@@@@@@@@
@@@@@@..@..@@@@@@@@@
@@@@@@@...@@@@@@@@@@
@@@@@@@.@..@@@@@@@@@
@@@@@...@.@.@@@@@@@@
@@@@@@@.@....@@@@@@@
@@@@@@@.@@@.@.@@@@@@
@@@@@@.@@@@....@@@@@
.@..@@...@.@@.@@@@@@
...@...@.......@@@@@
@@..@.@..@@.@.@@@@@@
...@@@@@.@@@...@@@@@
@@..@.@...@@@.@.@@@@
.@.@...@@.@@.....@@@
.....@@....@.@@@@@@@
@@.@....@.@@@@@@@@@@
14
4 18 0
12 17 0
8 18 0
13 12 0
5 8 0
10 12 0
4 17 0
1 13 0
2 17 0
1 15 0
9 18 0
9 3 0
6 19 0
0 15 0

10 2 0
11 13 0
8 18 0
7 6 0
5 14 0
2 12 0
4 17 0
12 17 0
6 12 0
5 16 0
13 11 0
10 7 0
7 9 0
9 9 0
