width 20
height 20
@@...@.@@@@@@@@@@@@@
@@@.@...@@@@@@@@@@@@
@@....@@.@.@@@@@@@@@
@.@.@..........@@@@@
.....@.@.@.@.@..@@@@
.@.@..@.@.@...@@@@@@
@@@@@...@.@.@@@@@@@@
.@@@..@.@.....@@@@@@
..@..@..@.@.@@@@@@.@
.@@@@@@..@@@.@@@@...
.....@@.@.@@..@@.@.@
@.@.@.@....@.@...@.@
@@......@.@...@@.@.@
@@@.@@.@...@@.......
@@..@@@@@.@@..@.@@.@
@@@....@@@...@@@@@@@
@...@@.....@..@@@@@@
@@.@@@.@@.@@@@@@@@@@
@@@.@.@.....@@@@@@@@
@@......@.@@@@@@@@@@
14
16 10 0
4 15 0
0 10 0
14 11 0
6 4 0
1 16 0
10 2 0
10 11 0
10 18 0
3 3 0
9 6 0
9 13 0
7 16 0
15 13 0

5 18 0
5 5 0
3 0 0
8 18 0
9 14 0
7 19 0
6 19 0
16 13 0
9 5 0
6 8 0
13 16 0
2 19 0
2 14 0
0 7 0
