width 20
height 20
@@...@.@@.@@@.@..@@.
@@@@.......@@.@@....
@....@@.@.@....@@.@.
@@.@.@.@.@.@@.@...@@
@@@...........@.@..@
@@..@.@@@.@.@....@@@
@.@@@@@....@@@@.@.@@
@...@@@@@.@@@.......
..@..@@.@.@...@.@.@.
.@@.@@.....@@@.@@..@
.@..@@.@@.@@......@.
@@@.@@@@@@@@@.@.@...
@@...@@@@.@@@..@.@.@
@.@.@.@@..@@@.@@..@@
@.@.....@.@@..@..@@@
....@.@...@@@...@.@@
@.@..@..@@.@..@....@
@@@@@@@.@....@@.@@..
@@@@@@....@.@@@@...@
@@@@@@@.@.@.@@@@.@.@
14
4 2 0
13 12 0
18 1 0
0 9 0
11 5 0
12 14 0
16 5 0
18 12 0
15 5 0
11 18 0
16 0 0
11 19 0
13 10 0
10 6 0

0 10 0
11 19 0
9 19 0
16 13 0
2 7 0
15 10 0
19 0 0
13 7 0
14 2 0
11 18 0
16 0 0
3 15 0
5 4 0
3 9 0
