width 20
height 20
@@@@@@@@@@@@@..@..@@
@@@@@@@@@@@@..@..@.@
@@@@@@.@.@@..@@@...@
@@@@@@...@.@..@@@@..
@@@@@@@@.....@.....@
@@@@@@@@.@.@..@.@@@@
@@@@@@@@@...@@..@@@@
@.@..@@@@.@@..@..@@@
....@@@@..@@@..@.@@@
@.@..@@@@..@.@...@@@
@@..@@@@@@.@...@....
@@@.....@....@@..@.@
@@@@.@.@.@.@...@@..@
@@@@@@.@...@.@@...@.
@@.@.....@@...@@.@..
@@...@.@..@@.@@@.@.@
@@@@..@@@@@@..@@@@..
@@...@@...@@@.....@.
@@.@.@.@.@.@..@.@.@.
@@.@...@.....@..@...
4
12 18 0
19 19 0
16 11 0
15 13 0

19 3 0
13 16 0
2 18 0
8 12 0
