width 20
height 20
@@@@@@@@@@..@@@@@@@@
@@@@@@@@@..@.@.@.@@@
@@@@@@@@.@...@.@.@@@
@@@@@@.@.@.@@.....@@
@@@@@.......@.@@.@@@
@@@@@@.@@.@.@.@.@@@@
@@@@@.@@...@@...@@@@
@@@@@...@.@.@@@.@.@.
@@@@@@@......@..@...
@@@@@@@@@.@.@@@.@.@@
@@@@@@@....@.@@....@
...@@@@@.@......@.@@
.@@..@@@.@.@.@.@..@@
.@@@....@@.@..@.@..@
..@@@.@..@@@.@@...@@
@.@@@.@.@.@@@.@.@..@
......@....@....@.@@
@.@.@@@@.@@.@.@.@...
..@@@@@@.......@..@.
@.@@@....@@.@.@..@..
4
7 7 0
15 19 0
18 19 0
1 14 0

6 13 0
19 8 0
12 11 0
0 11 0
