width 20
height 20
@@@@@@@..@.@@.@@@@@@
@@@@@@@@....@.@@@@@@
@@@@@@@.@.@.@..@@@@@
@@@@@@....@@.@...@@@
@@@@@@@.@@@....@..@@
@@@@@@....@@.@..@..@
@@@....@.@.@.@.@@.@@
@@..@.@......@@@@@@@
@.@.@.@.@@@.@.@@@@@@
@....@..@.....@@@@@@
@@.@@@@..@.@.@@@@@@@
.......@@@@..@@@@@@@
@.@.@.@@@@@@.@@@@@@@
.@.@@.@.@@@@@@@@@@@@
.........@@@@@@@@@@@
@.@.@@.@@@@@@@@@@@@@
..@@@@@@@@@@@@@@@@@@
.@@@@@@@@@@@@@@@@@@@
..@@@@@@@@@@@@@@@@@@
.@@@@@@@@@@@@@@@@@@@
4
9 7 0
11 4 0
8 1 0
3 12 0

2 14 0
7 0 0
5 6 0
1 12 0
