width 20
height 20
.........@@.........
.@..................
.........@..........
.@..@............@..
...@........@@..@...
.........@....@.....
...@...............@
..@...@.............
.@......@.....@.....
..........@.....@...
@....@..............
..@......@...@......
.................@..
.......@...@........
.@............@.....
.....@..............
...@............@@..
........@.......@@@@
............@....@@@
.................@@@
3
7 16 0
0 5 1
15 11 2

8 18 0
15 3 1
4 11 2
