width 20
height 20
....@@@..@@@@.......
.........@..........
....................
.....@.......@..@..@
...............@....
....................
.............@....@.
.@.....@............
...@.....@.@..@.....
......@........@....
...........@....@...
........@...........
...@..@....@.....@..
..............@.....
.@....@..@..........
...........@........
..............@.....
....@....@..........
......@.......@.....
......@.............
3
17 4 0
9 19 1
13 5 2

1 18 0
10 16 1
16 14 2
