width 20
height 20
@@@@@@@.@.@....@@@.@
@@@@@@......@.@@@@.@
@@@@@@.@.@.@@..@@@.@
@@@@@@@@@....@......
@@@@@@@@.@.@@@.@.@.@
@@@@@@@@.@.@.@@.@@..
@@.@@@@.......@....@
@@.@@@..@@.@.@@.@.@@
....@.@@@@.@@...@..@
.@.@..@@@@@@@@.@.@@@
@....@@.@@.@@.....@@
.@.@.....@.@..@@@@@@
.@@..@@@.@..@.@@@@@@
..@@.@.@@@.@@.@@@@@@
@.@..@.........@@@@@
...@.@.@.@@@.@@@@@@@
@@.....@@....@@@@@@@
@..@@@@@@@@@...@@@@@
@@....@@....@@.@@@@@
@@@.@.@..@@....@@@@@
11
14 9 0
15 10 0
13 1 0
4 13 0
7 7 1
4 11 1
12 17 1
14 19 1
8 19 2
11 18 2
7 1 2

13 8 0
18 1 0
9 14 0
10 5 0
12 7 1
11 16 1
9 1 1
2 15 1
14 8 2
6 16 2
8 5 2
