width 20
height 20
@..@@@.@.@@.@.@@@@@@
@@.@..........@@@@@@
@@...@.@.@@.@@@@@@@@
...@..@..@@@@@@@@@@@
@.@..@@@.@@@@@@@@@@@
.@.@...@@@@..@@@@@@@
.....@@@@@@.@@.@@@@@
@@@.@.@@@@......@@@@
.......@@@@.@.@@@@@@
@@@.@.@....@....@@@@
....@.@@@@...@@..@@@
.@@..@@@...@@@@.@@@@
...@..@@@.@@@@@@@@@@
.@.@@@@@@....@@@@@@@
@.........@.@@@@@@@@
@@.@.@.@@@@@@@@@@@@@
@@@@@......@@@@@@@@@
@@.@.@.@.@.@@@@@@@@@
@.......@..@@@@@@@@@
@@.@.@.@@@@@@@@@@@@@
11
8 3 0
2 18 0
14 6 0
2 6 0
13 8 1
6 0 1
1 0 1
9 13 1
0 5 2
4 14 2
14 9 2

4 15 0
6 2 0
5 1 0
5 14 0
1 3 1
11 5 1
2 6 1
12 13 1
6 17 2
8 9 2
13 0 2
