width 20
height 20
@@@@@@@@@@..@@.@@@@@
@@@@@@@@@@.@@@..@@@@
@.@@@@@@@......@@@@@
@..@@@.@.@.@.@.@@@@@
@.@.@......@@..@@@@@
.....@@.@@..@@.@@@@@
@.@@.@....@@...@@@@@
@.@.@.@.@.@@@.@@@@@@
........@@@@@@@@@@@@
.@@@.@.@@@@@@@@@@@@@
...@@@..@@@@@@@@@@@@
.@..@@.@@@@@@@@@@@@@
@..@@@.@@@@@@@@@@@@@
@@..@@@@@@@@@@@@@@@@
@@@.@@@@@@@@@@@@@@@@
@...@@@@@@@@@@@@@@@@
@@.@@@@@@@@@@@@@@@@@
@@@@@@@@@@@@@@@@@@@@
@@@@@@@@@@@@@@@@@@@@
@@@@@@@@@@@@@@@@@@@@
11
4 8 0
12 6 0
1 4 0
6 9 0
12 2 1
11 0 1
0 8 1
2 16 1
9 4 2
3 4 2
2 12 2

10 4 0
7 8 0
2 5 0
6 10 0
5 8 1
11 5 1
10 1 1
10 3 1
3 11 2
3 15 2
13 4 2
