width 20
height 20
...@@...............
......@....@..@....@
..........@......@@@
....@...@@.......@..
..........@.@.......
...@..@............@
.....@....@..@@.....
.@......@...........
.................@..
...................@
.........@..........
.............@....@.
................@...
......@.@.@.........
...@.@..............
.................@..
@...........@..@....
@.......@.........@.
@@...@.@....@.......
@@.......@.........@
3
3 18 0
6 2 0
19 14 0

19 10 0
15 12 0
8 19 0
