width 20
height 20
@@@@@@@@@...@@.@..@@
@@@@@@@@..@.@....@@@
@@@@@@@..@@..@.@...@
@@@@@@.@@.@@.@@..@..
@@@............@@..@
@@.@.@.@.@.@.@...@.@
@....@@.@@@.@@.@....
.@.@.@@.@.@.@@@@@.@.
....@@@......@.@...@
.@@.@@@.@@.@.....@..
.@@@....@.@@@.@.@..@
..@@@.@...@@@..@@@@@
.@.@.@@.@.@@@.@@@@@@
.....@@@...@@@@@@@@@
.@.@...@.@@.@.@@@@@@
@.@..@.@....@..@.@@@
@..@@@..@.@.@@....@@
@.@@@..@@@.....@.@.@
..@.@.@@@@@.@.@.....
@......@@@@@...@.@@.
9
9 12 0
6 15 0
19 19 0
6 17 0
18 2 0
14 17 0
15 9 0
7 8 0
16 16 0

2 8 0
19 6 0
18 17 0
11 14 0
1 18 0
19 9 0
0 14 0
14 11 0
14 16 0
