width 20
height 20
.........@@.@@@@@@@.
.@.@@.@.@@@..@@@.@@.
..@@@@...@@.@.@...@.
.@@@@@.@.@@.....@...
@@@@@@..@.@@@.@..@.@
@@@@@..@......@.@.@@
@@@@@@...@.@@.@...@@
@@@@@..@..@...@@@..@
@@@@@@..@@..@..@..@.
@@@@@@@@@@@..@..@...
@@@@@.@.@@@.@.@@.@@.
@@@@@.@..@..@.....@.
@@@@@.@.@.@.@@@.@...
@@@@..........@@.@.@
@@@@@.@.@.@.@@@...@@
@@@@...@@..@.@.@.@.@
@@@@@.@...@.........
@@@@@@.@@.@.@.@.@.@.
@@@@@........@@@..@.
@@@@@@.@@.@.@@@@@..@
9
4 0 0
6 15 0
17 5 0
13 4 0
12 13 0
14 9 0
17 8 0
17 6 0
10 15 0

17 11 0
9 13 0
5 18 0
14 11 0
7 2 0
15 2 0
15 5 0
13 10 0
17 16 0
