width 20
height 20
...@.@...@.@.@......
@.@@...@.@.....@@.@.
.....@@.@..@@.@@.@..
@@.@....@@.@.@.....@
...@@.@.......@@@@..
@.@.@@..@@@.@.@..@.@
@@...@.@.@.@.@.@..@@
@@@@.............@..
@@@.@.@@@@.@@@.@@@.@
@@.....@...@@@@.@...
@.@@.@@@@@..@....@.@
...@.@.@.@.@@@.@.@.@
.@..@........@@@....
.@.@.@.@.@.@...@.@.@
@.......@@@@.@@...@.
.@.@.@.@.@@.@.@.@...
....@@.........@@.@.
.@.@@@@.@.@.@.@..@..
.@@.@@@@@..@....@.@.
....@@@@@.@@@@@.....
9
9 18 0
0 13 0
10 2 0
14 8 0
11 12 0
1 4 0
6 7 0
10 16 0
1 19 0

15 3 0
17 16 0
0 13 0
9 2 0
10 12 0
19 14 0
5 12 0
15 18 0
2 3 0
