width 20
height 20
........@...........
@...................
@...@........@......
....................
.........@.......@..
..........@.........
.@..@.@.............
.............@@@@...
.....@..@.@..@@@@...
.................@..
....................
.........@..@.......
@....@..............
@@.....@............
...@......@.........
............@.....@.
..@.................
......@............@
.........@.........@
.................@..
9
6 12 0
1 15 0
5 5 0
4 14 1
7 11 1
5 3 1
10 19 2
4 7 2
5 6 2

11 1 0
19 11 0
2 4 0
14 2 1
11 6 1
18 16 1
17 6 2
18 18 2
5 7 2
