width 20
height 20
.....@..............
...@...@.......@....
..................@.
..@...@......@......
.......@......@.....
...@......@.........
.....@..............
..............@.@...
.............@..@...
@.....@...@.........
...@.@@.............
........@.....@.@...
@................@..
..@.....@...........
....@.....@.........
....................
........@..@........
........@......@....
...@................
......@....@........
9
0 3 0
18 6 0
17 14 0
10 16 1
1 11 1
7 10 1
18 13 2
5 15 2
7 15 2

13 15 0
10 0 0
9 3 0
10 6 1
18 7 1
3 8 1
0 4 2
18 15 2
15 8 2
