width 20
height 20
.@@@@@.@@.@@@@@@@@@@
.@@@@......@@@.@@@..
....@@.@.@...@..@.@.
@.@.@...@@.@@.@.....
@@....@@@@@.....@.@.
@@@.@..@....@.@@.@..
@@@@.@...@.@@@.....@
@@@..@.@..@....@.@..
@@@@...@.@@.@.@...@.
@@.@.@@..@@@@@.@.@.@
.....@@@@@@@@@......
@@.@.@@@@@@@@@.@.@@.
@@@..@@@@@@@@@@..@@@
@@@@.@@@@@@@@@@@.@@@
@@@@.@@@@@@@@@@@@@@@
@@@..@@@@@@@@@@@@@@@
@@@@@@@@@@@@@@@@@@@@
@@@@@@@@@@@@@@@@@@@@
@@@@@@@@@@@@@@@@@@@@
@@@@@@@@@@@@@@@@@@@@
4
16 10 0
18 5 0
15 2 1
19 10 2

15 2 0
17 8 0
12 2 1
9 1 2
