width 20
height 20
@@@@@@@@@@@@@@@@@@@@
@@@@@@@@@@@@@@@@@@@@
@@@@@@@@@@@@@@@@@@@@
@@@@@@@@@@@@@@@@@@@@
@@@@@@@@@@@@@@@@@@@@
@@@@@@@@@@@@@@@@@@@@
@@@@@@@@@@@@@@@@@@@@
@@@@@@@@@@@@@@@@@@@@
@@@@@@@@@@@@@@@@@@@@
@@@@.@@@@@@@@@@@@@@@
@@@...@@@@@@@@@@@@@@
@@@@.@.@...@@@@@@@@@
@@@@...@@.@.@@@@@@@.
.@@..@.......@@@.@..
...@@.@.@.@.@.@@...@
.@@.@..@@@......@@..
....@@..@@.@@.@....@
@.@....@.@..@.@@@@..
@@@@.@.....@@@@@...@
@@@@..@.@@..@@@@.@@@
4
8 13 0
1 14 0
5 10 1
4 18 2

6 16 0
10 11 0
0 15 1
5 14 2
