width 20
height 20
@.@@..@@@.@@@@@@@@.@
.....@@@...@@@@.....
.@@@@.@.@.@.@@@@.@@.
.@@.......@.@@@@@...
...@.@@.@.@.@@@@@@.@
.@@..@.@.@...@@@@...
...@.@.@...@@@.@.@.@
.@@@.....@..........
.@.@@@.@@..@.@.@.@.@
...@@@.@@@..@@.@@..@
.@@@@....@.@.....@.@
...@.@.@..@@@@.@..@@
@@...@@..@@@@@@@@@@@
..@@....@@@@@@@@@@@@
@.@.@.@.@@@@@@@@@@@@
.......@@@@@@@@@@@@@
@.@.@.@@@@@@@@@@@@@@
...@...@@@@@@@@@@@@@
@.@@@.@@@@@@@@@@@@@@
@@@@@@@@@@@@@@@@@@@@
19
5 14 0
6 8 0
0 13 0
1 14 0
1 4 0
14 10 0
9 0 0
16 10 0
17 3 0
6 9 0
0 17 0
6 17 0
0 8 0
1 6 0
4 5 0
7 4 0
2 4 0
8 1 0
5 13 0

0 17 0
0 9 0
1 15 0
18 0 0
6 8 0
12 5 0
1 4 0
1 0 0
7 7 0
0 5 0
18 9 0
19 2 0
5 17 0
3 3 0
4 3 0
8 6 0
11 4 0
18 1 0
3 14 0
