width 20
height 20
@..................@
........@....@......
....................
....@....@.@...@....
....................
....@.......@.....@.
.....@..............
...............@....
..@.................
...........@........
....................
...@..@....@..@...@.
.....@..............
..........@.......@.
@...................
....@.@.@...........
.......@.@..@.......
................@...
@@..................
@...................
15
3 8 0
17 4 0
18 18 0
17 3 0
1 2 0
14 3 1
18 12 1
2 13 1
10 16 1
19 12 1
8 17 2
9 15 2
19 13 2
2 15 2
4 2 2

11 18 0
11 4 0
16 0 0
6 1 0
11 6 0
5 1 1
3 3 1
2 13 1
15 16 1
0 4 1
10 17 2
7 17 2
2 1 2
11 13 2
5 5 2
