width 20
height 20
@...................
....................
...@...........@....
....@...........@...
..............@...@.
.@..@......@........
...@.@...@..........
.@.....@......@.@.@.
....................
.....@.@........@...
....................
..........@...@.....
......@.........@...
....................
..@......@..........
.....@............@.
.@..........@...@...
....@...............
..........@.........
.@..................
15
19 9 0
8 0 0
19 2 0
14 9 0
5 13 0
19 8 1
17 15 1
17 12 1
9 11 1
8 13 1
5 11 2
1 6 2
9 5 2
2 10 2
11 15 2

7 14 0
2 7 0
8 3 0
19 19 0
15 1 0
8 2 1
9 7 1
6 3 1
6 19 1
8 12 1
19 17 2
17 16 2
17 0 2
19 5 2
5 10 2
