width 20
height 20
..@@@@@@@...@@@@@@@@
@..@@@@@..@@@@@@@@@@
@.@.@.@@@.@.@@@@@@@@
.......@@...@@@@@@@@
@.@.@.@@.@@..@@@@@@@
..@@@....@@.@.@@.@@@
@@.@@@.@@.@.......@@
@@..@..@....@.@@.@..
@@.@@@.@@.@..@.@.@.@
@...@.....@.@.......
@.@.@.@.@@@@@@.@@.@@
..@..@@@.@...@...@@@
.@@@..@....@.@.@@@@@
.@@..@.@.@.@...@@@@@
.@@@......@@@.@@@@@@
@....@.@@@@@@@@@@@@@
.@.@.@...@@@@@@@@@@@
....@@.@..@@@@@@@@@@
@.@@@@@@@@@@@@@@@@@@
..@@@@@@@@@@@@@@@@@@
10
1 10 0
15 6 0
9 6 0
2 1 0
4 16 1
7 14 1
3 2 1
0 17 2
8 7 2
2 6 2

1 0 0
3 17 0
10 12 0
10 11 0
8 13 1
1 18 1
8 12 1
1 4 2
0 17 2
11 8 2
