width 20
height 20
@....@.@@.@@......@@
@@.@......@@.@.@.@@@
....@.@.@.....@@..@@
.@.@@@@@..@@.@...@@@
..@@@@@.@..@@..@@@@@
.@.@@@@...@@@@@@@@@@
......@.@@@@@@@@@@@@
.@.@.@..@.@@@@@@@@@@
.@@...@...@@@@@@@@@@
.@@@@.@@@....@@@@@@@
@@@@@...@.@.@.@@@@@@
@@@@@@.@..@...@@@@@@
@.@.@.@@@..@.@@@@@@@
......@...@..@@@@@@@
@.@.@...@@@@@@@@@@@@
...@.@.@@@@@@@@@@@@@
.@....@@@@@@@@@@@@@@
@..@.@@@@@@@@@@@@@@@
..@@.@@@@@@@@@@@@@@@
@.@@@@@@@@@@@@@@@@@@
10
1 2 0
0 5 0
3 0 0
6 14 0
2 6 1
4 15 1
13 10 1
1 13 2
12 9 2
1 0 2

0 4 0
9 1 0
10 9 0
0 7 0
1 18 1
4 16 1
13 11 1
8 11 2
4 8 2
1 0 2
