width 20
height 20
@@@@@@@@@....@@@...@
@@@@@.@@.@.@.@...@..
@@@@..@.....@.@@@..@
@@@@@...@.@...@.@.@@
@@@@@@@..@@.@.......
@@@@@@..@.@.@.@.@.@@
@@@@@@@....@@..@....
@@@@@@.@@.@@@.@@@@.@
@@@@......@@.@@@....
@@@.@.@@.@@@..@..@@.
@@@.@..@.@@@@.@.@...
@.@.@@@....@....@.@.
.....@..@.@..@.@@.@.
@@@@.@.@@@@@.@..@@..
@@@@....@.@@@.@@@@@.
@@@@@@@....@...@..@.
@@....@.@.@.@.@.@..@
@..@@@.@@.....@...@.
@@........@.@...@...
...@@.@.@..@..@@@.@@
13
9 15 0
7 16 0
17 10 0
12 13 0
3 18 0
7 11 0
14 4 0
7 19 0
16 15 0
8 18 0
19 17 0
0 12 0
1 17 0

7 15 0
17 3 0
8 1 0
16 9 0
9 16 0
0 19 0
15 13 0
12 11 0
3 18 0
15 11 0
19 13 0
6 12 0
18 0 0
