width 20
height 20
@@@@@@.@.@@@...@.@@@
@@@@@@....@..@....@@
@@@@@@.@.@@@.@@.@@@@
@@@@@@.@@.@.@.....@@
@@@@@...@.....@.@..@
@@@@@@@...@.@@.@@.@@
@@@@@@@.@..@....@...
@@@@.@.@..@.@.@.@.@.
@@@@....@......@@@..
@@...@@.@.@.@@@@@@@.
...@..@..@...@@@@@@@
.@..@@..@.@.@@@@@@@@
..@...@......@@@@@@@
@@.@.@@.@@.@.@@@@@@@
.....@@...@@..@.@@@@
.@.@.@..@.@..@@..@@@
..@.@@.@...@....@@@@
.@..@.@@@.@@@.@.@@@@
...@...@@..@..@@.@@.
.@...@@@@.@@@.......
13
0 16 0
12 4 0
7 8 0
6 15 0
5 12 0
15 16 0
10 10 0
0 14 0
10 4 0
14 0 0
18 6 0
4 19 0
15 1 0

0 12 0
7 13 0
13 4 0
4 9 0
16 1 0
12 6 0
2 14 0
15 14 0
1 10 0
18 6 0
9 6 0
9 12 0
15 1 0
