width 20
height 20
......@@@@@@@@@@@@@@
@.@.@@@@@@@@@.@@@@@@
@..@@@@@@@@@...@@@@@
..@@@@@@@@@.@.@@@.@@
.@@@@@@@@@........@@
..@@@@@@@.@@@.@.@.@@
.@@@@@@@...@@@...@@@
.@@@@@@@@@.@@..@.@@@
.@@@@@@.@@....@...@@
..@@@......@@@@@.@@@
.@@@@@@.@.@@@@@..@@@
.@@...@@@@@@.@.@..@@
..@.@@@@..@@.....@@@
.@...@@.@....@.@..@@
.@.@.@....@.@@@..@@@
...@.@@@.@..@..@.@@@
.@.@@....@.@.@....@@
@@.@.@@.@.@...@@.@@@
...........@.@.@...@
@.@.@.@.@@.....@.@@@
13
15 8 0
8 9 0
5 18 0
16 10 0
14 4 0
11 14 0
2 13 0
1 19 0
17 4 0
11 19 0
5 19 0
1 0 0
9 12 0

1 0 0
11 4 0
5 9 0
1 3 0
2 0 0
12 12 0
16 11 0
13 8 0
11 17 0
14 13 0
15 4 0
1 12 0
2 2 0
