width 20
height 20
.........@..........
....................
..............@.....
....@.....@.........
...............@....
....................
.....@......@.......
..........@....@....
.......@.@..@@......
...@................
@...@.......@....@..
.@...@..@.@.......@.
...............@....
..@......@..........
..........@.........
.....@..@...........
.............@......
...............@....
...@................
.......@@...........
8
7 0 0
2 3 0
9 3 0
9 9 0
11 1 0
7 10 0
4 18 0
13 6 0

3 3 0
14 19 0
5 4 0
3 15 0
10 2 0
6 11 0
17 6 0
18 19 0
