width 20
height 20
..@@@@.@..@@.....@.@
@..@.....@@@@.@@....
..@@.@.@.@@@@@@@@@.@
@..@.@.@..@@@@@@@...
@.@@@.@@@..@@@@@.@.@
.........@.@........
@@.@.@@@.....@.@@@.@
.@..@....@.@.@....@@
...@..@@@@@@@.@.@.@@
@.@@@...@@.....@@.@@
...@..@@...@@@...@@@
@.@.@.@.@@.@.@@.@@@@
@.@............@@@@@
@@@.@.@.@.@.@.@@@@@@
@@@.@@.@@..@..@@@@@@
@@@@@.....@.@@@@@.@.
@@@@..@.@.@.@@@...@.
@@@@@..@..@.@@@@@...
@@@@@.@.@.......@.@.
@@@@..@...@.@.@...@@
11
9 17 0
2 6 0
4 2 0
12 9 0
6 7 0
3 7 0
19 1 0
9 4 0
4 8 0
12 7 0
11 16 0

16 0 0
11 13 0
13 12 0
19 15 0
8 19 0
3 12 0
8 5 0
10 5 0
5 5 0
13 5 0
18 0 0
