width 20
height 20
@@@@@@@@@@@@@@@@@@@@
@@@@@@@@@@@@@@@@@@@@
@@@@@@@@@@@@@@@@@@@@
@@@@@@@@@@.@@@@@@@@@
@@@@@..@@.....@@@@@@
@@@@..@.@@.@@.@@@@@@
@@@@@....@.@..@@@@@@
@@@@.@@.@@@@@.@@@@@@
@@@.....@@@@..@@@@@@
@@@@.@@@.@.@@..@@@@@
@@@....@......@@@@@@
@...@.@@.@@@@..@@@@.
..@@.@@@....@.@@@@..
@.@......@.@@..@@@@.
....@.@.@@@@@.@.@.@.
.@.@@@@@@@@@........
..@@@@@@@@@@@@@@.@@@
.@@@@@@@@@@@@@@@@@@@
@@@@@@@@@@@@@@@@@@@@
@@@@@@@@@@@@@@@@@@@@
11
10 9 0
8 11 0
5 8 0
7 14 0
8 13 0
0 16 0
2 11 0
5 11 0
10 6 0
0 15 0
0 12 0

13 5 0
7 6 0
6 8 0
13 4 0
12 8 0
3 8 0
13 15 0
7 13 0
13 12 0
12 6 0
1 13 0
