width 20
height 20
....................
....................
...@.........@......
.......@.@..........
...........@...@....
....................
.......@...@........
.....@..............
.@.....@.@..@.......
....@........@....@.
.....@......@.......
@@.......@..........
@@.............@..@.
....................
@@.......@...@.@.@..
@...................
@......@.......@....
@@..................
@........@...@.@....
....................
5
6 10 0
14 14 0
16 12 1
2 12 1
3 11 2

18 15 0
10 17 0
16 13 1
6 10 1
12 15 2
