width 20
height 20
.............@......
.......@............
.@..................
.......@...........@
......@.............
...............@....
.....@...@..@...@...
...............@....
.@........@.........
........@....@...@..
...@................
@...@.............@.
...............@....
.@..@........@...@..
@@..................
.@...@......@..@....
..................@.
...@.........@......
....................
..................@@
2
11 5 0
0 17 1

0 19 0
8 16 1
