width 20
height 20
................@@..
.........@..........
...........@........
.@..................
....@.......@.......
.....@.....@....@.@.
@..............@....
@...@..@............
....................
.@.......@.@.....@..
........@......@....
..@@................
..@@..@.............
.........@..@@@@.@..
.....@......@@@.....
............@@@.....
............@@@.@.@.
............@@.....@
.........@.@@@......
@@..................
2
8 8 0
14 4 1

14 9 0
15 12 1
