width 20
height 20
....................
....................
....................
....@..@....@.......
...............@....
....................
@........@..........
@................@..
....@........@......
.....@.....@....@...
....................
...@................
..@....@.@....@.....
....@...............
..@..@..............
.......@.........@..
..@..@....@.........
....@...@.........@@
..........@.......@@
..........@@......@@
1
16 1 0

14 5 0
