width 20
height 20
...................@
...........@.......@
...@...............@
..@.......@.@.......
....................
...@...........@....
.....@..............
...@...@....@.@.....
....................
..@.......@........@
.@.............@@...
....................
......@....@........
...@...@....@.......
..............@.....
.........@......@...
.............@.....@
....@.@...@........@
....................
...........@........
1
17 19 0

3 10 0
