width 20
height 20
...@@.@@.@.@.@...@.@
.@.............@@..@
.@.@.@.@.@.@.@..@@.@
@@..@..@.@.@@..@@...
@@.@@@@@@.@..@.@.@.@
....@@@@@...@@......
.@.@@@@@..@...@.@.@.
@...@@@@.@@.@...@@..
@@@..@@@.@@@..@.@@@.
@@@.@@@.@.@.@@.@.@.@
@...................
.@.@@.@.@.@@.@.@.@.@
.....@...@@@.@@..@@@
.@.@@@@.@.@....@...@
..@@@@.....@.@@.@.@.
@.@@@@@.@.@..@@...@.
@@@@@@@@..@@@.@.@...
@@@@@@@@@.@.....@.@.
@@@@@@@@@@@@@@.@@@..
@@@@@@@@@@@@....@..@
7
17 19 0
12 11 0
8 7 0
0 12 0
18 19 0
7 9 0
19 15 0

12 19 0
19 6 0
15 0 0
10 3 0
3 12 0
0 6 0
7 14 0
