width 20
height 20
@@@@@@@@@@@@@@@@.@..
@@@@@@@@@@.@.@@@..@.
@@@@@@@@@.....@.@...
@@@@@@@@@@@@@.....@.
@@@@@@@@@...@.@.@@@.
@@@@@@@@@@@....@@@..
@@@@@@@@@@..@@.@@.@.
@@@@@@@@@@@...@.....
@@@@@@@@..@@.@.@.@@.
@@@@@@@@@......@.@..
@@@@@@@@@.@@.@..@..@
@@@@@@@@@..@..@@.@..
@@@@@@@@@.@..@@@...@
@@@@@@@@@@..@@@@.@@@
@@@@@@@@@@@.@@@..@@@
@@@@@@@@@@@..@@@.@@@
@@@@@@@@@@@@@@@@.@@@
@@@@@@@@@@@@@@@.....
@@@@@@@@@@@@@@@@.@.@
@@@@@@@@@@@@@@@@.@..
7
14 10 0
17 17 0
11 15 0
13 4 0
16 14 0
12 11 0
17 1 0

15 7 0
13 3 0
14 5 0
12 11 0
12 8 0
19 9 0
18 0 0
