width 20
height 20
.....@@@...........@
.......@....@.......
...................@
...................@
..@....@.@...@.....@
....@..............@
@..........@.......@
..@....@........@...
..@.@......@..@.....
....................
....................
.......@...@.@......
.................@..
....@.......@..@....
..@..@..............
......@......@@.....
...........@........
............@.....@.
..@.................
....................
12
13 9 0
16 19 0
9 12 0
15 16 0
16 17 1
19 19 1
11 5 1
17 18 1
17 10 2
7 2 2
5 10 2
9 0 2

0 18 0
5 6 0
19 1 0
1 12 0
16 16 1
4 12 1
12 5 1
15 19 1
13 13 2
4 19 2
10 10 2
16 12 2
