width 20
height 20
.................@@@
.................@@@
.....@..@.......@...
....................
.....@@..@..........
...@............@...
.............@......
.........@..........
....@..........@....
......@.............
.........@..........
..........@..@.@..@@
....................
....................
@...@...........@@..
@.......@@..@...@@..
........@@...@..@@@@
...@...@@@......@@@@
.......@..@@....@@@@
.........@@@....@@@@
12
12 18 0
6 12 0
3 0 0
15 1 0
14 6 1
3 18 1
5 12 1
5 10 1
2 6 2
9 5 2
8 12 2
2 14 2

15 6 0
15 0 0
13 15 0
18 5 0
2 3 1
19 2 1
16 0 1
18 3 1
1 7 2
12 3 2
0 11 2
2 8 2
