width 20
height 20
@@@@@@@@@@@@@@@@@.@.
@@@@@@@@@@@@@@@@....
@@@.@@@@@@@@@@@@@@@.
@@...@@@@@@@@.@@.@..
@@.@@@@@.@@.......@.
....@@@.....@.@.@...
@@.@.@..@@@..@...@@.
@......@@@..@.@@...@
.@.@.@..@.@....@@@@@
....@@.@@...@@@@@@@@
@.@.@..@..@@@.@@@@@@
...@.@@..@@@...@@@@@
@.@.....@@@@@.@@@@@@
..@@.@@@@@@@@.@@@@@@
.@@.@@@@@@@@..@@@@@@
.....@@@@@@.@..@@@@@
@.@@....@@....@@@@@@
....@.@....@.@@@@@@@
@.@..@..@.@@@@@@@@@@
..@@..@@@@@@@@@@@@@@
11
6 12 0
9 18 0
1 16 0
10 17 0
2 3 0
1 15 0
12 16 0
4 15 0
4 3 0
5 19 0
16 7 0

8 17 0
0 13 0
13 13 0
1 9 0
3 9 0
0 14 0
3 10 0
11 4 0
12 14 0
13 15 0
4 8 0
