width 20
height 20
@@@@.....@@@@@@@@@@@
@@@@@@.@@@@@@@@@@@@@
@@@..@..@@@@@@@@@@@@
@...@..@@@@@@.@@@@@@
@@.@@@.@@@@.@.@@@@@@
@...@@.@@.@.@.@@@@@@
.@.@....@..........@
.....@.@@.@@.@@@.@.@
.@@.@....@..@.@@@..@
.@@.@@.@@@@...@.@@..
..@@@@...@@@.@@.@@.@
@...@..@@.@........@
@@.@@@.@....@.@.@.@@
...@@.@.@@@.@@@@..@.
@@.............@@.@.
.@@.@@.@.@.@@.@@....
....@.@.@@@@@@@@@.@.
@.@.......@@@@@@@@@.
@@@.@.@@.@@@@@@@@...
@@@@....@@@@@@@@@@@.
11
6 14 0
6 4 0
19 19 0
0 7 0
18 6 0
7 8 0
3 17 0
8 10 0
14 11 0
4 6 0
4 14 0

7 8 0
1 3 0
10 14 0
1 7 0
2 3 0
1 16 0
17 13 0
18 6 0
6 1 0
12 7 0
12 6 0
