width 20
height 20
@@@@@@@@@@@@..@.....
@@@@@@@.@@@..@@.@@@.
@@@@@....@@@..@..@@.
@@@@@.@.@@@.@...@@@@
@@@@@@@..@...@@...@@
@@@@@@..@..@....@@@@
@@.@.@@..@@..@@@@@@.
@....@..@@@@.@.@.@@.
@.@.@.@..@@.........
@@......@.@@.@.@@.@.
@@@.@.@.......@@@@..
@@..@@@@@.@.@..@@@@.
@.@..@...@@@@@..@@@@
....@.@.@@@@@@@@@@@@
@.@......@@@@@@@@@@@
@@@.@.@.@@@@@@@@@@@@
@...@@@@@@@@@@@@@@@@
@.@.@@@@@@@@@@@@@@@@
...@@@@@@@@@@@@@@@@@
@.@@@@@@@@@@@@@@@@@@
3
2 13 0
12 0 0
1 7 0

7 7 0
1 18 0
19 0 0
