width 20
height 20
.@@.@@@...@.@@@....@
.....@..@.@.@@@@.@..
@.@.@..@..@..@@@.@.@
@@...@.@@...@@@..@@@
...@.@@..@@..@@@.@@@
.@.@.@@@....@@...@@@
.@@...@..@.@..@@.@.@
.@.@@...@@@@@.@@....
.@....@@.@.@..@..@@.
@..@.@@....@@...@@@.
..@@@@.@.@....@...@@
@.@@@....@@.@.@.@@@@
...@@@.@..@..@@..@@@
@.@@@.@..@@@...@@@@@
...@....@@@@.@.@.@@@
@@..@.@..@@..@.....@
@@@...@@@@..@@.@.@@@
@@..@@.@@@@..@.@.@@@
@@@.....@...@@@@@@@@
@@@@.@@@@.@..@@@@@@@
3
16 8 0
11 16 0
15 15 0

4 6 0
4 3 0
12 13 0
