width 20
height 20
......@............@
...................@
....@......@..@.....
................@...
....@...@...@.......
..@..@..............
......@......@......
....................
.@.........@....@..@
........@..........@
....................
...@........@...@...
.......@............
....@........@.@....
..............@.@.@.
...@...@..@.........
...@................
........@...@.......
..............@...@.
....@...............
7
4 12 0
7 6 0
19 10 0
3 9 1
19 11 1
19 15 2
13 14 2

17 15 0
18 19 0
6 15 0
7 7 1
2 2 1
18 16 2
12 5 2
