width 20
height 20
....................
............@.......
....@.@.......@.....
.......@..........@.
......@.@...........
..............@.....
@....@..............
........@...@.@.....
....@....@..........
@...................
@...@..@.....@......
....................
........@...@.@.....
....@.....@....@.@.@
.@@....@..........@@
........@...........
.............@......
...@................
....@.............@@
..................@@
7
14 11 0
9 5 0
10 19 0
18 0 1
1 0 1
8 0 2
16 10 2

11 16 0
10 7 0
13 15 0
18 15 1
4 17 1
7 0 2
5 5 2
