width 20
height 20
@@@@@.........@....@
@@@@@.@.@@.@@@.@.@@.
@@@@@.@@............
@@@@..@.@@.@.@.@.@.@
@@@@@.@..@@.@..@@.@@
@.@@@@..@@@..@.....@
@..@@.@..@..@@@.@@..
..@.....@.@..@@@...@
@...@.@....@.....@..
..@.@@@@@@.@.@.@..@.
@..@@.@.......@@@.@.
..@@..@@@@.@.@.@.@..
@.@.@..@..@@......@.
......@..@.@.@.@@..@
@.@.@@@@...@..@...@@
@@..@@@..@...@@.@..@
@.@@.@.@..@@.@...@..
@........@@@@@@.@.@@
@.@.@.@@..@@@@......
@@@@...@.@@@@@@.@@.@
3
18 8 0
15 18 0
12 8 0

4 3 0
5 0 0
3 8 0
