width 20
height 20
.@...@@.@@.@..@@@@@@
...@@........@@@@@@@
@@..@@@.@@@.@@@@@@@@
.@.@@.@.@.@@.@.@@@@@
....@............@@@
@@.@.@@@.@.@.@.@.@@@
..........@@..@.@@@@
.@.@.@.@@...@....@@@
@.@.@.@...@.@.@.@.@@
@......@.@@@@@..@...
@.@.@.@.@.@.@.@.@.@.
...@...............@
@.@@@.@.@.@.@.@.@.@@
...@.@.@@..@@@@@.@@@
.@...@.@.@@.@.@@.@@@
@..@..............@@
@@..@.@.@.@.@.@@.@@@
@..@...@...@....@.@@
@@..@.@@@.@.@.@.....
@..@...@@@.....@.@.@
3
4 14 0
5 9 0
8 8 0

13 11 0
1 17 0
4 7 0
