width 20
height 20
@..@@@.@.@...@@@@@@@
..@.@@.....@.@.@.@@@
@....@.@.@@.......@@
..@.@@@.@..@.@.@.@.@
@..@@.@.@@..@@@.....
@.@.......@.@@.@.@.@
....@.@.@.@.....@..@
.@.@...@@...@.@@@@.@
@.@.@.@..@@.@.@@@..@
@...@.@.@.@.@@.@.@.@
..@...@....@.@.....@
.@.@@@..@.@....@.@.@
...@.@.@....@.@.@@@.
.@......@@.@.@...@..
@.@.@@.@.....@.@@.@.
@.@.@.@..@.@........
....@.@@.@@..@.@@.@.
@.@.@.....@@@....@..
@.@@@@.@.@@@@@@@..@.
@...@@@@@@@@@@@@.@@@
6
12 3 0
5 16 0
5 9 1
7 3 1
13 11 2
2 7 2

11 4 0
0 3 0
10 14 1
11 2 1
9 11 2
0 16 2
