width 20
height 20
@.@.@....@@@....@@..
......@.@.@@@.@.@.@.
@.@.@..@...@.@......
@@...@..@.@...@@.@@.
@@@.@@.@....@.@.@.@.
@.@..@.@@@@..@......
@...@@..@.@.@.@.@.@.
@@.@.@@@@........@..
@@........@@.@@.@.@@
@.@@.@.@@@@@.@.@@.@.
..@..@@.@@@@........
@..@.@...@@@@@.@.@.@
..@.@.@.@.@.@..@@@..
@............@.@..@.
@@@.@.@.@@.@@.@.@.@.
@@@@...@..@.@.......
@@@.@.@.@.....@.@.@@
@@@.......@.@..@.@..
@@@@.@.@@.@..@.....@
@@@@@@...@@@..@@.@..
6
11 7 0
14 12 0
16 11 1
18 2 1
3 4 2
6 4 2

7 16 0
6 5 0
1 0 1
15 7 1
16 2 2
4 8 2
