width 20
height 20
@............@......
@......@..........@@
@...........@.....@@
...@.@..............
....................
..@....@..@...@.....
....................
.@.............@....
.......@....@....@..
...@................
@...@....@...@@...@.
...@................
..............@.....
.........@......@.@.
.@..........@.@.....
....................
......@.........@...
........@.@.@.......
....................
....................
4
5 2 0
9 4 0
17 3 0
17 17 0

15 16 0
3 4 0
6 8 0
13 19 0
