width 20
height 20
@@@@@@@@.........@@@
@@@@@@@@.....@.@....
....@@@@.....@...@..
@@@.@@@.............
............@.......
................@...
...@........@.....@.
.....@.............@
.......@............
...@................
.@.............@@...
........@...........
.....@.@............
..........@.@.@@@@@.
..............@@@@@@
..........@...@@@@@@
.....@...@....@@@@@@
...............@@@@@
...............@@@@@
@@.............@@@@@
4
9 7 0
3 14 0
0 15 0
1 15 0

0 18 0
15 2 0
0 15 0
15 5 0
