width 55
height 55
@@.........@@.......@.................@........@@......
@@......@..@@...@....@.................................
@@..........@......@@......@....@...@..................
@@..@.....@......................@........@............
.....@.@...........@...@.....@....@.@.@.......@....@...
...............................@...@...................
..........@...............................@.@.@......@.
.....@.....@....@......@....@.........................@
......@...........@...........@...........@..@........@
..........@........@........................@.........@
......@...............@.@.....@.@.......@......@.......
@.......@...........................@..@..........@....
...@.........@@.....@............@....@...@.@..........
@......@.@........@@....@...........................@..
@@.......@.@..@....@@..........@.@.....................
@@..@...@@..@...@.....@..@.........@........@..@...@...
@@.............@.@.@........@..........................
...........@.....................@.@.@...@...@.........
.........@....@..@.....@...............@..@....@..@....
....@..........@....@...@.@.......@.@...............@..
.........@...........................@......@.@........
.....@.@....@...............@.........@................
...........@.....@...@..@............@....@.......@....
...@...@.............@@................................
.......@....@.......@.........@.....@.......@..........
..@.@........@...@...@.......@...........@......@......
........@.........@.....@.@........@.@........@....@...
..@@@........@.@......................@..@.............
..@.....@..@......@...@................@.....@.........
..........................@.........@....@.....@.......
...@.....@........@......@@......@..........@.....@....
.......@.....@...@....@...@.....@...................@..
...@..........@@....................@................@.
....@........@@@....@.......@...@....@.@.........@.....
....@...@....@@@.......@....................@..........
...........@.@@@......@....@..@..@........@......@.....
...................................@...................
....@..@..........@.......@.@....@....@......@..@.@....
.............@.........@...........@.@....@............
..........@...........@...........@......@.........@.@.
..........................@.@....................@..@..
....@..........@.@.........@..@........@...............
.........@@........@...........@.@.@.@.................
..@.......@..@.........@.@........@.....@....@..@......
....................@.@....@@.@..........@.......@.....
..@..........@....@.......@.........@.......@..........
...@.........................@...........@.@.....@.....
.........@.@......................@....................
........@.@........@.........@.@..........@....@..@....
..............@..................@.@...@.@.........@...
................@....@.@.@...@....@....................
................................@...........@..........
...@..@.@......@..................@.@..................
..........................@..................@.@.......
................@.....................................@
25
37 27 0
17 5 0
29 40 0
35 50 0
32 35 0
6 0 0
11 18 0
43 47 0
37 34 0
43 8 0
40 33 0
20 31 0
23 19 0
24 34 0
10 37 0
1 7 0
31 13 0
38 39 0
43 53 0
33 0 0
10 30 0
46 27 0
19 6 0
46 45 0
6 7 0

34 14 0
49 11 0
48 48 0
45 48 0
32 36 0
18 0 0
50 7 0
1 12 0
25 36 0
35 41 0
46 50 0
27 52 0
49 25 0
44 10 0
51 33 0
51 27 0
33 16 0
47 44 0
49 42 0
44 1 0
53 1 0
37 18 0
36 20 0
44 29 0
35 4 0
