width 20
height 20
@@@@@.....@@.@.@@@@@
@@@@@@@.@........@@@
@@@@@@@@@@@@.@@.@.@@
@@@@@@@@@@@@@......@
@@@@@@@@@@@@.@.@.@..
@@@@@@@@@@@....@@..@
@@@@@@@@@@.@.@.@@@@@
@@.@@@@.@.....@@@@@@
@@..@@....@.@.@@@@@@
@@@...@.@@..@@@@@@@@
...@@...@.@..@@@@@@@
.@@@..@....@@.@@@@@@
.@.@@@..@.@.@..@@@@@
...@..@@......@@@@@@
.@..@...@.@.@@@@@@@@
..@..@.@...@@@@@@@@@
.@.@.....@..@@@@@@@@
....@@.@@@@@@@@@@@@@
.@.@..@@@@@@@@@@@@@@
.@...@@@@@@@@@@@@@@@
3
13 13 0
3 17 0
4 11 0

6 8 0
12 10 0
4 9 0
