width 20
height 20
@@@@@..@.........@@@
@@@.@@...@@.@@@@..@@
@@....@.@@@.@..@.@@@
@@.@.@@@@@....@...@@
@@@...@.@.@@@.@@@..@
@@.@.@....@......@@@
@.....@.@.@@.@@@.@.@
@.@.@....@@@...@.@..
..@@.@.@.@@@@@..@.@.
@@......@@@..@.@....
@@@@.@.@.@.@.....@.@
@@@@.@.......@.@@@@@
@@@@@..@.@.@.@@@@@@@
@@@@@@.@@@@...@@@@@@
@@@@@@@@@@@@.@@@@@@@
@@@@@@@@.@@..@@@@@@@
@@@@@@@@.@..@@@@@@@@
@@@@@@@....@@@@@@@@@
@@@@@@@@.@..@@@@@@@@
@@@@@@@...@...@@@@@@
3
1 6 0
5 9 0
17 4 0

10 11 0
16 10 0
2 3 0
