width 20
height 20
@@@@.@@..@..@@@@..@@
@@@..@..@@.@@@@@@..@
@@@@...@@...@@@@@.@.
@@...@@..@.@..@.....
@@@.@.@.@@..@.@.@.@.
@@........@.....@@@.
@@@.@@@@.@.@@@.@..@.
@@@@@@@..........@..
@@@@@..@.@@.@@.@.@@.
@@@@@@...@....@.@...
@@@@@@@@@.@@@.@.@@.@
@@@@.@..@.@.@....@.@
@@@@..@.......@.@@@@
@@@@@..@.@.@.@...@@@
@@@@@@....@@.@@.@.@@
@@@@@@@@.@@@@@@.@.@@
@@@@@@@@@@@@@@......
@@@@@@@@@@@@@@@.@.@@
@@@@@@@@@@@@@@@@..@.
@@@@@@@@@@@@@@@@@...
3
11 11 0
9 11 0
19 16 0

11 11 0
19 8 0
7 0 0
