width 20
height 20
@@@@@.....@.@..@@...
..@@@.@@.@@.@.@...@.
@..@...@.@......@@@@
..@@@.@.@.@.@@@@@@@@
@.@@@.........@@@@@@
.....@@.@.@@.@@@@@@@
@.@@....@@...@@@@@@@
....@.@.@..@...@@@@@
.@@.@@...@@..@..@@@@
@@.@..@@.@..@@@..@@@
@....@.@.@.@@@@.@@@@
@@.@......@.@@@.@@@@
@..@.@.@@.....@@@@@@
@@@@@@@...@@@.@@@@@@
@@@@@@@@.@@@@@@@@@@@
@@@@@@@@@@@@@@@@@@@@
@@@@@@@@@@@@@@@@@@@@
@@@@@@@@@@@@@@@@@@@@
@@@@@@@@@@@@@@@@@@@@
@@@@@@@@@@@@@@@@@@@@
4
2 9 0
1 1 0
19 1 1
7 8 2

8 10 0
15 9 0
6 12 1
7 7 2
