width 20
height 20
@@@@@@@@@@@@.@@@@@.@
@@@@@@@@@@@..@@.....
@@@@@@@@.@@.@@@.@@.@
@@@@@@@.......@.@@@@
@@@@@@@@.@@.@...@@@@
@@@@@@@....@@@@..@@@
@@@@@@@@.@@@@.@@.@@@
@.@@.@..@.@.@.@@..@@
@......@@........@@@
@@@.@@....@.@.@@@@@@
@@.@.@.@.@.@@..@.@@@
@@......@.....@....@
@..@@@.@..@.@.@.@@..
..@@@..@@..@@@.@...@
@@@@@@.@..@.@@.@@.@@
@@@@@@@@@..........@
@@@@@@@@@.@.@.@@.@@.
@@@@@@@@.@..@@@.....
@@@@@@@....@.@@@@.@.
@@@@....@@.......@..
4
10 18 0
16 5 0
15 3 1
14 8 2

10 15 0
10 5 0
6 9 1
18 19 2
