width 20
height 20
@@@@@@@@@@@@@.@@@@@@
@@@@@@@@...@@...@.@.
@@@@@@@@.@@...@.....
@@@@@@@...@@.@..@@.@
@@@@@@..@.....@..@@.
@@@@@@@.@.@.@@@.@.@.
@@@@@@@@..@@@.......
@@@@@@@@@.@..@.@.@.@
@@.@@@.@@@@.@...@@@.
.@..@..@@...@@.@@.@.
...@.@..@@@..@......
.@.....@.@@.@.@@.@@.
@@@@.@..........@...
.@@..@@.@.@.@.@.@@@.
...@...@.@.@@@......
@.@..@.@....@..@@.@.
....@....@.@@@.@@@..
.@.@.@@.@...@@@@@@@.
@@@@.@@@@.@..@.@.@..
@@@@.......@.....@@@
6
4 17 0
19 17 0
18 2 0
19 11 0
11 11 0
14 10 0

12 18 0
3 16 0
1 14 0
19 12 0
10 9 0
14 9 0
