width 20
height 20
.......@@@.......@.@
....@...............
..@..............@..
....................
................@...
.............@......
....@..@......@.....
..@......@.@........
.................@..
.....@..........@...
..@....@......@....@
............@.......
.......@...@....@...
..........@......@..
@...................
@.......@.@.........
@@..................
@.......@.......@...
@...@....@.@........
@....@.......@......
8
4 4 0
1 17 0
12 0 0
19 2 1
9 9 1
6 13 1
18 7 2
14 18 2

15 18 0
13 4 0
10 6 0
11 15 1
14 18 1
17 3 1
19 11 2
5 5 2
