width 20
height 20
................@@..
...@................
.....@.@............
....................
@@@.....@.....@..@..
@@@.........@.......
..........@.........
.....@.@............
....................
....................
.......@.@..@.......
....................
....@.......@.....@@
................@@@@
.......@..........@@
..@..............@@@
.................@@@
............@......@
........@........@@@
.........@.......@@@
6
0 8 0
18 4 0
12 16 1
1 13 1
16 7 2
14 15 2

7 8 0
16 5 0
16 2 1
2 13 1
6 4 2
4 1 2
