width 20
height 20
.......@@....@......
.....@..............
...............@....
................@...
..@.@.....@.@.......
.........@......@..@
........@..@........
....................
...@..@......@.....@
.....@.............@
..........@........@
....................
..............@.....
....................
....@.........@.....
.@@........@.@...@..
.@@.@...............
.......@...@....@...
....................
....................
6
7 7 0
14 2 0
7 15 1
7 16 1
12 8 2
11 7 2

8 7 0
9 9 0
12 6 1
18 0 1
1 19 2
4 17 2
