width 20
height 20
....................
.........@..........
.......@............
..........@.@.......
...@...@............
........@...@......@
..@..@..............
.........@......@...
.......@............
.........@..........
..........@.....@...
..@.....@.....@.....
...................@
.......@.@...@......
.....@..............
..@......@......@...
...@..@..@@........@
.......@....@......@
..........@.......@@
.@.....@..........@@
6
13 17 0
8 3 0
1 12 1
2 18 1
13 14 2
13 16 2

2 10 0
12 6 0
17 4 1
19 1 1
12 1 2
4 18 2
