width 20
height 20
@@...@..@@@@...@@@@@
@@.@...@@@@@.@...@@@
@@@.@@..@@...@@.@..@
@.@.@.@...@.@@@...@@
........@..@.@@.@@@@
.@.@@.@@..@..@.....@
..@@.@@.@...@.@.@.@@
@.....@...@......@@@
@@.@.@.@@.@.@.@.@@@@
@@@@...@.@@@..@@@@@@
@..@@@...@@@@...@@@@
.@.@..@@..@@@.@@@@@@
...@.@.@.@.@.@@@@@@@
.@............@@@@@@
..@@@@@.@@.@.@@@@@@@
.@.@@@@...@@..@@@@@@
...@@@@@@@@.@.@@@@@@
@@..@.@..@@.@..@@@@@
@.@.@.@.@@....@@@@@@
......@....@.@@@@@@@
8
1 16 0
9 6 0
17 3 0
2 13 0
12 12 0
15 7 0
5 3 0
14 7 0

8 17 0
1 10 0
9 7 0
8 12 0
9 15 0
1 14 0
5 18 0
5 19 0
