width 20
height 20
@.@.@@@@.@....@@@...
..........@@.@.@@@.@
@.@@.@.@@@@@.....@.@
....@..@@@@..@@@....
.@.@@@...@@.@.@@@.@.
.@.@@@@.@...@.@.@@..
@...@.....@......@@.
@@@@@@.@.@..@.@.@@..
@.@@@...@..@..@.@@.@
...@@@.@.@..@.@.@@..
@.@......@.@@@..@..@
@..@.@.@..@.@.@@..@@
.@.@..@@@.....@@@@@@
...@.@.@@@.@@.@@..@@
@.@......@@@.....@@@
....@.@.@@@@.@.@..@@
.@@.@@...@@@@.@@.@@@
...@@..@@@@@@.@@.@@@
.@..@@.@@@@@......@@
@..@@@@@@@@@.@.@.@@@
8
5 3 0
12 15 0
10 0 0
12 12 0
1 17 0
1 15 0
5 10 0
3 16 0

0 4 0
16 15 0
14 1 0
12 18 0
2 19 0
0 18 0
16 11 0
18 0 0
