width 20
height 20
@@..@@@@@@@@@@..@@@.
@.@..@@@@@@@@@@.@@@.
..@.@@@@@@@@@@...@..
@....@@@.@.@@@.@@@.@
@.@.@@@........@.@.@
@@..@@.@.@.@.@......
@@@......@@.@.@@.@@@
@@@@@.@.@........@.@
@..@@@.@..@.@@.@....
..@.@....@@...@..@@@
@.....@.@@@@@@@@.@..
@@.@.@@@@@@@@@@@@..@
@@.@@.@.@@.@.@@..@.@
....@........@@@....
.@.@@.@.@@.@@....@.@
..@@@@.@....@.@.@@@@
.@@@@@.@@.@@@..@@@@@
...@@@........@@@@@@
.@.@@@.@.@.@@..@@@@@
@.......@...@@.@@@@@
8
5 19 0
4 19 0
16 12 0
19 1 0
3 13 0
14 0 0
11 4 0
3 1 0

12 7 0
13 17 0
16 2 0
19 2 0
7 9 0
6 17 0
16 12 0
2 18 0
