width 20
height 20
@@@@@.@.@@..@..@@@@@
@@@@@.@.@.@.@.@.@@@@
@@@..............@@@
@@@@@.@@@@.@.@@@..@@
@@@@..@@..@...@..@@@
.@@@.@.@.@@@.@..@@@@
.@@@@.....@...@@@@@@
..@@..@.@...@@..@@@@
.@...@.@@.@...@..@@@
...@...@.@.@@...@@@@
.@@@.@......@.@..@@@
@@@@@@@.@.@..@@@@@@@
@@@@@@...@@.@@@@@@@@
@@@@@@.@@@@..@@@@@@@
@@@@@@@@@@@@.@@@@@@@
@@@@@@@......@@@@@@@
@@@@@@@@.@.@.@@@@@@@
@@@@@@@@@@@@@@@@@@@@
@@@@@@@@@@@@@@@@@@@@
@@@@@@@@@@@@@@@@@@@@
8
7 10 0
7 2 0
6 8 0
9 1 0
11 13 0
9 2 0
11 7 0
12 5 0

4 5 0
15 8 0
6 9 0
0 8 0
12 6 0
9 2 0
11 15 0
16 8 0
