width 20
height 20
@@@@@@.@.@.@.@.@@@@@
@@@@@..........@@@@@
@@@@@@.@@.@.@@..@@@@
@@@@@@.@..@@.@.@.@@@
@@@@@@@.@@........@@
@@@.@@@.@.@@.@.@@@@@
@@@..@........@...@@
@@@.@.@.@.@@.@@@@...
........@@...@@@@.@@
@.@.@@@..@@@@.@@@...
..@@....@......@..@.
@.@@@.@..@@.@.@@@.@.
@@.@.@.@.@@@.......@
@@........@@@.@.@.@.
@@@@.@.@.@.@.@@@....
@@@@@...@@...@@.@.@@
@@@@.@.@.@.@@.@.@...
@@@@.@...@........@@
@@@....@...@.@@.@...
@@..@.@@@@..@....@.@
8
15 19 0
14 17 0
15 13 0
10 15 0
12 0 0
9 5 0
14 2 0
18 9 0

5 7 0
17 12 0
1 8 0
11 17 0
19 18 0
12 6 0
9 10 0
6 17 0
