width 20
height 20
@@@@@@@@@@..@@@@..@.
@@@@@@@@@@@.@.@.@...
@@@@@.@@@@........@.
@@.....@..@.@.@@.@..
@.@@@.@.@..@@@..@@@.
@........@.@@@.@....
..@@@.@.@..@@@.@@.@.
.@.@.@.@@@..@..@@@..
.....@.@@@.@.@.@@.@.
.@.@................
@@..@@.@.@.@.@.@.@.@
...@@.@@@.@...@..@@@
@.@.@......@.@@@@@@@
......@.@.@@@@@@@@@@
@.@.@..@@@@@@@@@@@@@
@@.@@.@@@.@@@@@@@@@@
...........@@@@@@@@@
.@@.@.@.@.@.@@.@@@@@
...@@..@.......@@@@@
.@...@..@.@.@.@@@@@@
8
1 18 0
18 9 0
16 9 0
2 7 0
5 18 0
13 7 0
5 13 0
7 16 0

0 17 0
14 17 0
12 18 0
3 12 0
19 5 0
14 5 0
16 0 0
16 3 0
