width 20
height 20
@@@..@.@....@...@..@
@@@.@..@@.@@.@.@..@@
@@...@.@.........@.@
@.@.@..@@.@@.@@@....
......@@@...@@..@.@.
.@.@.@.@.@.@..@....@
.@.@.....@@@@.@.@.@.
@...@.@@@..@..@..@..
..@@@@@.@@..@.@.@.@.
@..@@.....@.........
@@....@.@...@@.@@.@.
@@.@.@...@@.@..@...@
@@..@@@.@@...@@.@@..
...@@@@@@.@.@......@
@.@.@@@......@.@.@@.
.....@@@.@@.@.@.....
@.@.@.@@@.....@@.@.@
@@.....@..@.@@@.@@..
@@@.@.@.@@.@@......@
@@@@.......@@@.@.@..
8
14 10 0
8 0 0
18 15 0
16 19 0
13 6 0
4 15 0
17 10 0
2 15 0

12 5 0
15 6 0
18 12 0
11 11 0
13 6 0
5 18 0
9 19 0
18 15 0
