width 20
height 20
@@@@....@@.@.@.@@@@@
@@@.@.@.........@@@@
@@@.@@.@.@.@.@.@.@@@
@@@.......@@..@...@@
..@.@@@.@@.@@@.@.@@@
.@..@.@@@@........@@
...@@......@.@@.@...
.@....@.@.@.@@@@..@.
.@.@.@.@@@@.@.@.@..@
.@..@@..@........@..
.@.@@@.@@@@.@.@.@@.@
@@.@......@..@@@@...
@@..@.@.@...@@@@@@.@
@.@..@@@..@@@@.....@
....@.@.@..@.@.@.@..
.@@.......@....@..@.
@@@.@.@@.@@@.@@@@@@.
@@@@...@.@@@@@@@@@..
@@@@@.@@..@@@@@@@@@.
@@@@@@@@.@@@@@@@@@@@
5
19 11 0
0 8 0
13 9 1
13 5 1
18 6 2

8 19 0
3 15 0
8 2 1
9 7 1
19 18 2
