width 20
height 20
@@@@@@.@.@@@@@@@@@@@
@@@@@.....@@@@@@@@@@
@@@@@@.@@...@@@@@@@@
@@@@.@..@.@@@@@@@@@@
@@@@...@..@@@@@@@@@@
@@@.@.@.@..@@@@@@@@@
@.....@..@..@@@@@@@@
@.@.@..@.@@@@@@@@@@@
@..@..@..@.@@@@@@@@@
.@@..@.@...@@@@@@@@@
...@....@@..@@@@@@@@
.@@@.@@@.@.@@@@@@@@@
.........@.@@@@@@@@@
@.@@@@.@....@@@@@@@@
....@@..@.@@@@@@@@@@
.@.@...@@@@@@@@@@@@@
@@.@.@.@@@@@@@@@@@@@
@@@@..@@@@@@@@@@@@@@
@@@@@..@@@@@@@@@@@@@
@@@@@.@@@@@@@@@@@@@@
5
8 11 0
5 17 0
9 3 1
8 0 1
4 12 2

9 4 0
1 6 0
2 16 1
6 1 1
4 10 2
