width 20
height 20
@@@@@@....@@@....@@@
@@@@@.@@@.....@@....
@@@@......@.@.@@@.@.
@@@@.@.@@.@@...@@..@
@@@@@@@...@@@.@...@@
@@@@@@@@.@.@.@.@@.@@
@@@@@@..........@@@@
@@@@@@@@@.@@@.@...@@
@@@@@@@..@@.@..@@...
@@@@@.@.@.....@@@@.@
@@@@@.....@.@.@@@@@@
@@@@@.@.@.@@.@@@@@@@
@@@@@@@.@....@@@@@@@
@@@@@@@@..@@@@@@@@@@
@@@@@@@@@@@@@@@@@@@@
@@@@@@@@@@@@@@@@@@@@
@@@@@@@@@@@@@@@@@@@@
@@@@@@@@@@@@@@@@@@@@
@@@@@@@@@@@@@@@@@@@@
@@@@@@@@@@@@@@@@@@@@
9
9 11 0
15 4 0
9 0 0
8 2 0
13 9 0
16 7 0
12 5 0
12 3 0
11 10 0

17 8 0
13 0 0
11 10 0
9 12 0
6 2 0
18 1 0
4 3 0
16 4 0
9 2 0
