width 20
height 20
@@@@@@@@..@@@@..@@@@
@@@@@@@@.@.@.@.@.@@@
@@@@@@@@...........@
@@@@@@@..@.@@.@@.@.@
@@@@@@@@.@.@...@@@.@
@.@@@@....@@.@@@@@..
....@..@@@@.@..@@@.@
@@@...@@@.....@@@...
@@@@@.@.@@@.@.@@.@.@
@@@..@@.....@.......
@@@@....@.@..@@@@@.@
@@@@@.@.@@.@@.@@@@..
@@@@...@......@@@.@.
@@@@@@...@@@@..@..@.
@@@@@..@.@@@..@.@.@@
@@@@@@.@@@@@@.......
@@@@@@.@.@.@@.@@.@@.
@@@@@....@.@....@...
@@@@@@.@...@@@.@.@@.
@@@@@@@..@..@....@@.
12
5 11 0
13 14 0
10 9 0
12 12 0
7 11 0
9 9 0
16 13 0
10 17 0
9 7 0
10 16 0
3 9 0
7 13 0

6 13 0
16 16 0
8 4 0
19 5 0
8 5 0
10 2 0
13 8 0
9 12 0
10 17 0
9 0 0
5 12 0
6 16 0
