width 20
height 20
....................
....................
@.......@.....@.....
@@..................
@@........@.........
.....@..............
..@...........@.@...
@..@..@..@.......@..
........@...@......@
.......@.......@.@..
....@......@..@.....
......@.@.@.........
....................
....@.@...........@.
.@............@.....
...........@........
@......@..@.........
..............@.....
...@.............@..
..................@@
15
4 15 0
0 14 0
6 19 0
2 2 0
8 7 0
4 3 1
9 6 1
2 3 1
17 5 1
18 17 1
19 5 2
11 17 2
5 8 2
13 15 2
11 9 2

8 0 0
1 12 0
11 0 0
4 8 0
4 12 0
19 7 1
9 14 1
13 7 1
8 19 1
18 17 1
19 5 2
9 17 2
15 10 2
0 0 2
19 10 2
