width 20
height 20
.........@@@@.......
......@....@@.......
.@..................
@...................
..........@..@......
....@......@........
@..@................
.......@.........@..
..@.................
................@...
......@.....@......@
....@...............
.@........@.......@.
...@................
...............@....
......@....@........
.................@.@
..........@.........
....................
.................@..
15
18 1 0
1 9 0
7 5 0
18 16 0
9 9 0
16 4 1
3 2 1
6 5 1
7 9 1
3 15 1
13 18 2
12 11 2
1 17 2
9 2 2
4 17 2

1 14 0
16 19 0
7 6 0
2 10 0
18 7 0
9 8 1
4 6 1
18 17 1
11 6 1
15 5 1
4 19 2
0 1 2
5 2 2
6 7 2
13 12 2
