width 20
height 20
..........@@@.......
..........@@........
.......@............
@..@.............@..
......@..@..@.......
........@.......@...
....................
....@.......@....@..
.................@..
....................
......@......@..@.@.
....................
@@@@............@...
@@@..........@......
...........@......@@
..........@....@...@
@....@..@...@......@
...........@........
...@@...............
..@@@...............
4
6 7 0
7 4 0
4 0 1
13 2 2

13 12 0
19 10 0
17 11 1
13 5 2
