width 20
height 20
@........@.......@..
.@..................
....................
.@...@.....@...@....
..@.....@....@......
....@...............
............@.......
..@.....@..@.@......
@@...@...@..........
@................@..
.........@..........
....@...@..@........
....................
@...............@...
......@...@..@......
...@................
..................@.
.....@......@.......
.......@....@@......
@...................
4
12 2 0
4 4 0
10 5 1
0 5 2

16 0 0
14 7 0
16 17 1
8 6 2
