width 20
height 20
.@.@.@@@@..@@@@@@@@@
.....@.@.@..@@@@@@@.
.@.@.......@@@@@@@..
@..@.@@@.@..@@@@@..@
..@.@.@.@.@.@.@@@@..
@@@............@@..@
@.@.@.@.@.@@.@@@.@..
@....@@@..@...@@...@
..@@@@@@@@.@@.@.@@..
@.@@@@.@........@.@.
@.@@@..@@.@.@.@.....
...@..@.@@@@@@@@@.@@
@.@.@...@.@.@.@@.@@@
......@..........@@@
@.@.@@@@.@@.@@.@.@@@
@.@.@.@.@@@@.@@.@.@@
...@...............@
@@...@@@@.@.@.@.@.@@
.@.@..@@@@...@@@..@@
...@.@@@@@@.@@@@@...
2
16 13 0
4 11 1

7 4 0
5 12 1
