width 45
height 45
..........................................@..
.....................................@..@.@..
..........................................@..
...@...@.......@........@.........@..........
..............@.....................@........
.............@...@..........@............@...
..@.....@.......@....@..@.@.................@
.......@...................@........@.......@
......@..............@.............@..@..@...
.@...............@..@.@.@......@.............
....@...@.......@.@......@......@......@.....
............@@............@@..@.....@........
.................@..@.....@@...............@.
..........@.@.............@...@..@...........
.......@.............@......@.....@..........
.@.@..@....@....@.........@.........@........
..@...........................@.......@...@..
.............@....@..........@...............
.@...@.@...@.....@........@.......@.......@.@
................@.....@..@............@......
...@.@.....@..@........@........@...........@
..........................@........@.........
..........@@@...........@............@.......
@......@..@@...@..............@..@...........
..@.......@@..........................@..@...
.......@....@......@....@......@.............
.............................@.....@..@......
@......@@@@@..@.@......@..@..........@.......
.....@..@@...........@..@......@.............
.................@......................@...@
......@.@.................@.@...............@
..@............@.................@...........
...@.............@....@..@..............@....
......@..@...@..........@...........@........
........@..................@.......@..@@....@
.......@...@...@...@.@.......@.............@@
......@....@..@.....@............@..........@
@...........@@...............@...............
@@........@..............@...................
....................@.@...@..@...@...........
...@.......@..@..@...........................
..........................@...@.........@....
........@.@...@.@.....@.........@........@...
@@.........@...@.............................
.................@@....@.@@..................
25
16 18 0
37 42 0
23 35 0
41 13 0
28 13 0
42 20 1
29 28 1
14 25 1
0 34 1
16 38 1
39 42 2
8 13 2
43 31 2
17 17 2
38 5 2
10 29 3
42 40 3
27 13 3
21 3 3
31 32 3
16 7 4
14 15 4
30 20 4
41 20 4
31 41 4

18 12 0
1 7 0
0 2 0
0 26 0
21 20 0
34 37 1
2 2 1
40 38 1
40 7 1
40 39 1
23 38 2
44 43 2
5 35 2
34 40 2
1 23 2
31 26 3
15 36 3
38 12 3
18 19 3
6 35 3
12 5 4
21 36 4
32 26 4
9 44 4
30 43 4
