width 20
height 20
@@@@@.@......@@@@@@@
@@@@....@.@.@.@@.@.@
@@..@.@@@@..........
@.@...@@@@@@.@.@.@.@
..@@@...@@..@@@...@.
.@@...@@...@.@.@.@@.
....@@@@.@..........
@.@.@@@@@@@.@@@@.@@@
...@@@@@@@.@........
.@@@@@@@@....@.@.@.@
@@@@@@@@.@.@..@@@...
@@@@@@@@....@@..@@@.
@@@@@@@@@.@@@@@.@.@.
@@@@@@@@@..@@@....@.
@@@@@@@@@.@@@.@@@..@
@@@@@@@@.......@.@.@
@@@@@@@@@.@.@@......
@@@@@@@@@@@@@..@@.@@
@@@@@@@@@@@...@....@
@@@@@@@@@@@@.@..@.@@
2
9 1 0
19 2 0

13 14 0
13 17 0
