width 20
height 20
....................
...........@..@.....
.......@............
..@..@......@....@..
...@.........@..@...
.......@.@..........
..........@...@.....
...@...@..........@.
.@......@.......@...
@...................
@....@......@.@.....
.@.......@..........
....................
....@......@..@..@..
...@..@.............
....................
...............@....
@..@.@..............
.......@.@..........
............@@@.....
12
19 18 0
10 2 0
18 1 0
19 19 0
12 12 1
16 16 1
13 13 1
13 3 1
11 3 2
15 3 2
18 10 2
11 17 2

3 9 0
11 3 0
6 13 0
18 18 0
9 14 1
5 15 1
15 10 1
3 13 1
11 4 2
18 13 2
5 18 2
11 17 2
