width 20
height 20
@...........@@@.....
........@...........
...........@...@....
...@..........@.....
................@...
...@.....@..........
..............@.....
.....@......@.......
..@....@.....@..@...
........@.@.........
....................
.......@.......@....
..................@.
..................@@
....@..@.......@....
.@........@.@.......
....@...............
...........@........
@@........@....@....
@................@@.
12
5 16 0
14 11 0
7 0 0
12 17 0
15 17 1
8 16 1
11 1 1
2 1 1
17 12 2
18 18 2
19 18 2
17 5 2

4 17 0
14 2 0
9 9 0
1 3 0
5 14 1
13 14 1
19 15 1
15 5 1
5 15 2
13 18 2
1 7 2
1 14 2
