width 20
height 20
@..@@@@@@@@@@@@@@@@@
@.@.@@.@@@@@@@@@@@@@
........@@@@@@@@@@@@
.@.@.@.@@@@@@@@@@@@@
..@..@...@@@@@@@@@@@
@@@@.@@@..@@@@@@@@@@
@.....@..@.@@@@@@@@@
@@.@.@.@....@@@@@@@@
@@@.....@@@@@@@@@@@@
@@..@@.@@@.@@@@@@@@@
@.@@.@.@.@..@@@@@@@@
...........@@@@@@@@@
@.@@.@.@@.@@@@@@@@@@
..@.@..@@...@@@@@@@@
.@..@.@@@.@@@@@@@@@@
...@.@..@...@@@@@@@@
.@.....@@@.@.@@@@@@@
@..@.@..@@....@@@@@@
..@.@@.@@.@.@@@@@@@@
@....@.....@@@@@@@@@
2
4 7 0
6 11 1

3 9 0
13 17 1
