width 20
height 20
@@@@@@@@@.@@@.@.@@@@
@@@@@@@@@........@@@
@@@@@@@@@.@@.@.@.@@@
@@@@@...@..@..@@@@@@
@@....@.@@..@@@@@@@@
@@@.@.@....@@@@@@@@@
@@@..@.@.@@@@@@@@@@@
@.@.@......@@@@@@@@@
...@@@.@.@.@@@@@@@@@
@.@@@..@@.@@.@@@@@@@
..@...@@@.@...@@@@@@
@.@.@@.@....@..@@@@@
.........@.@.@..@@@@
@.@.@@.@.@....@.@@@@
@..@.@@.@@@@.@@@..@@
.@....@...@...@@.@@@
...@@.@.@@.@.@@@..@@
@.@.........@@@..@@@
@@..@.@@.@.@.@.@.@@@
@@.@@...@........@@@
4
0 15 0
7 19 0
1 16 1
8 12 2

11 10 0
5 19 0
9 17 1
2 8 2
