width 20
height 20
@@@@@@@@@@@@@@@@@@@@
@@@@@@@@@@@@@@@@@@@@
@@@@@@@@@@@@@@@@@@@@
@@@@@@@@@@@@@@@@@@@@
@@@@@@@@@@@@@@@@@@@@
@@@@@@@@@@@@@@@@@@@@
@@@@@@@@@@@@@@@@@@@@
@@@@@@@@@@@@@@@@@@@@
@@@@@@@@@@@@@@@@@@@@
@@@@@@@@@@@@@@@@@@@@
.....@@@@@@@@@@@@@@@
.@.@@..@@@@@@@@@@@@@
@...@@..@@@.@@@@@@@@
@@@..@.@@@...@@@@@@@
.@..@...@.@.@.@@@@@@
.@@...@.....@....@@@
..@.@..@@@@...@.@@@@
@...@.@.@@@@.@@..@@@
@@@@.....@@.@@..@@@@
@@...@.@..@....@@@@@
4
6 18 0
0 15 0
3 14 1
13 19 2

16 17 0
14 18 0
1 12 1
2 10 2
