width 20
height 20
..@..@............@@
........@...........
..@.@...............
....................
..@......@...@......
....................
.....@........@.....
....@......@........
....................
...@...............@
..@....@............
@...................
@.......@.........@.
@........@..@.@.@...
@...................
...........@........
............@....@..
...@................
...........@........
.@.............@....
10
7 9 0
17 8 0
18 19 0
13 5 0
9 12 1
4 6 1
13 11 1
4 12 2
13 6 2
1 15 2

7 14 0
6 16 0
1 2 0
13 5 0
17 18 1
15 9 1
1 1 1
4 17 2
13 7 2
14 0 2
