width 20
height 20
@@@@................
@@..................
@.............@.....
......@.............
..@.................
......@.............
..........@..@..@...
..@...@.............
...@...........@....
.......@..........@.
....................
.....@.....@........
.........@......@.@.
.@@...@.............
.@.......@..........
.@..@...@.....@.....
@...................
@...@...............
@...................
..@..@..............
10
10 7 0
3 15 0
7 16 0
8 17 0
5 13 1
7 12 1
16 10 1
2 8 2
2 6 2
11 8 2

17 17 0
4 11 0
19 2 0
15 9 0
14 3 1
17 0 1
16 10 1
17 2 2
6 6 2
9 8 2
