width 20
height 20
.........@@....@@@@@
...@.....@@.........
.@...@....@.........
................@...
.@......@.....@.....
..@........@.@....@@
....................
......@...@.........
.......@.....@......
..............@.....
.........@..@..@....
........@........@..
@..@@..........@...@
@..@@.....@.@.......
@@@@@...............
@@................@.
@...................
@@.@...@............
@@..................
@@..@@.@..........@.
10
9 9 0
19 13 0
7 13 0
8 19 0
14 2 1
0 11 1
0 8 1
12 0 2
17 13 2
14 0 2

14 18 0
2 6 0
13 3 0
5 18 0
18 11 1
4 15 1
18 17 1
13 0 2
10 16 2
14 1 2
