width 20
height 20
.@@.@@.@@@@@@.@.....
..@......@@@....@@.@
@.@@.@.@.@@@.@@..@@@
@..@@@@@..@@@@..@...
@@.@.@.@.@.@..@..@.@
@@.........@.@.@....
@@@@@.@.@@......@@@.
@@@@@@@@@@.@.@.@@...
@@@@......@.@@....@@
@@@..@@.@.@....@.@.@
@@@@@@@@....@.@.@@..
@@@@@@@@@.@..@..@..@
@@@@@@@....@@@@..@..
@@@.@@.@@@..@@..@@@.
@@.........@@..@@...
@@@.@.@.@@.@@@....@.
@@@@@.@...@.@..@.@@.
@@@@@@@@@.....@@@...
@@@@@@@@..@.@.@.@.@.
@@@@@@@@@@@@@@.....@
13
18 17 0
17 19 0
7 14 0
10 14 0
4 9 0
6 8 0
12 1 0
15 3 0
19 14 0
13 17 0
13 4 0
16 16 0
5 5 0

17 8 0
9 12 0
15 19 0
7 14 0
11 13 0
11 17 0
17 7 0
10 17 0
10 10 0
19 6 0
14 8 0
9 5 0
13 14 0
