width 20
height 20
@@@@@@@@@@@@@@@.@@@@
@@@@@@@@@@@..@@...@@
@@@@@@@@@@@.@.@.@@.@
@@@@@.@@@@..@.@..@..
@@@@@..@.@@.@.@.@..@
@@@@@.@...........@@
@@@@....@.@.@@.@@..@
@.@.@.@..@@@@@@.@.@@
......@@@@@@@@.....@
.@@.@.@.@..@@@@.@.@@
...@.@@...@.@@@..@@.
.@......@...@@@.@.@.
.@.@.@.@@@@..@......
.@@..@.....@.@@.@.@@
@@@@..@.@@..@...@..@
@@@.@.@@@.@@.@.@@@..
@@....@.........@..@
@@@@@..@@.@@.@.@..@@
@@@@@@.@@@@@@..@@..@
@@@@@@@@@@@@@@..@.@@
13
16 5 0
17 19 0
14 15 0
10 11 0
2 16 0
16 1 0
5 8 0
9 9 0
17 9 0
17 18 0
15 2 0
13 14 0
5 15 0

4 10 0
7 6 0
18 6 0
19 12 0
4 11 0
7 7 0
11 11 0
15 16 0
7 16 0
2 12 0
18 8 0
3 11 0
18 16 0
