width 20
height 20
@..@@@@@@@@.......@.
.@.@@@@@@@@@@@.@@...
........@@@@.@.@..@.
@.@.@@@..@......@.@.
...@@@..@.@@.@.@.@@@
@.@@@@@......@@.....
@@@@@@..@@.@.@.@.@@.
@@@@@@.@@@..@.....@@
@@......@.@..@.@.@.@
@..@.@.@....@@@.....
..@@.@..@.@.@@..@.@.
@..@.@@@...@@@@.@@..
@.@.@...@@@@.....@@@
....@.@.@.@.@@@.@...
@.@...@...........@.
.@.@.@.@.@.@.@.@.@@.
........@...@@@.@@..
@.@@.@.@@@@.@.@.@.@.
@...@.@.@.@@........
..@.........@.@@.@.@
3
7 5 0
19 18 1
17 3 2

4 2 0
6 2 1
12 5 2
