width 20
height 20
@@@@@.......@..@.@.@
@@@.@.@.@.@@.@......
@@...@..@@@@...@.@@.
@.@.@.@.@.@@@.@..@@.
..@...........@@...@
@.@@.@@.@@@.@...@.@@
.......@.@@@@@.@.@@@
.@.@.@......@.....@@
@.@..@.@.@.@@@.@@..@
@.@@@.@.@...@@@..@@@
....@....@.@.@.@....
@.@..@.@@....@...@.@
.@@@.@.@.@@@.@.@.@..
................@@@.
@.@.@@@.@@.@.@@@.@@.
...@...@.@@.@@@@...@
@.@.@@...@@..@@..@..
.......@.@.@.@.@.@@.
@.@.@.@....@......@.
@@..@.@@.@...@.@.@..
3
5 3 0
1 6 1
16 3 2

13 18 0
12 18 1
6 4 2
