width 20
height 20
.@@@@@@.@.......@@@.
..@@@@...@.@@.@@@@@.
@..@@@@.@.@.@.@@@@..
@.@.@@........@@@..@
......@.@@.@@.@@.@.@
.@.@@..@@@@.........
@.@.@.@.@.@.@@.@.@.@
.............@.@@..@
.@@.@@@.@.@.@...@.@@
@...@..@...@..@@.@.@
@@.@..@@.@@@.@......
@@...@@.@.@.@.@@.@.@
@@.@............@...
@@@@@.@.@.@.@.@..@.@
@@@@...@@@...@.@.@.@
@@@@@.@@@@@.@.......
@@@@@@@@@@@@..@@@@.@
@@@@@@@@@@@.@...@@@@
@@@@@@@@@@....@..@@@
@@@@@@@@@@@@.@..@@@@
3
3 4 0
14 5 1
8 7 2

10 4 0
16 13 1
9 7 2
