width 20
height 20
...........@.......@
.@.@.@.@.@...@@@.@..
..@.@@..@@@.@.@@..@@
.@@....@@@.....@@@..
..@.@@@.@.@@.@.....@
.@.@.@@...@@@..@.@@@
@@......@..@.@..@..@
...@.@.@@@.....@.@..
@.@.@.@.@.@@.@.@...@
..........@.@@@.@@..
.@.@.@.@@..........@
@...@..@..@@.@.@.@..
.@.@@.@@@.@@@..@.@.@
.@.@@@.@.@.@.@@.@@.@
..@.@..@............
@.....@..@.@.@.@.@@.
..@.@.@@..@..@@...@@
.@.@.@@..@@@@@@@.@.@
.....@.@.@@.@@@.....
@.@@.........@@@.@.@
3
6 14 0
0 10 1
4 0 2

0 7 0
14 8 1
4 6 2
