width 20
height 20
@...@@@@@@@@@@@@@@@@
.@@.@@@@@@@@@@@@@@@@
....@@@@@@@@@@@@@@@@
.@@.@@@@@@@@@@@@@@@@
..@@@@@@@@@@@@@@@@@@
.@@.@.@@@@@@@@@@@@@@
......@@@@@@@@@@@@@@
.@.@@..@@@@@@@@@@@@.
@.@@@.@@@@@@@@@@@@..
...@...@@@@@@@@@@.@.
@@.@@.@.@.@@.@@@....
..............@.@.@.
.@.@.@@@.@.@.@.....@
..@@....@@@@...@.@..
.@.@.@@....@@@..@@@@
....@@@@@@.@@.@.@@@@
@.@@@@..@..@.....@@@
@@@.@@.@.@.@@.@.@@@@
@..........@.@.@@@@@
@@.@.@.@.@.....@@@@@
11
16 10 0
1 11 0
14 12 0
3 6 0
17 10 1
12 19 1
7 16 1
12 18 1
8 17 2
19 11 2
19 13 2

2 0 0
1 18 0
4 19 0
4 11 0
17 12 1
7 16 1
1 2 1
14 14 1
19 10 2
12 16 2
2 7 2
