width 20
height 20
@@@@.@@@@@...@.@.@.@
@@@..@@@@@.@.......@
@@.@...@@..@.@@@.@@.
....@.@..@..@...@...
@.@.....@@.@.@@...@.
.@..@@.@........@.@.
..@.@.@.@@@@.@@..@..
@...@...@.@@@@@@@.@.
@.@@@.@....@@@@@....
...@...@@.@.@@@.@.@.
.@@.@@..@.@........@
.......@....@.@.@.@@
@.@.@.@..@@.@..@...@
@@@..@@@.@.@.@@.@.@.
@@.@..@@@.....@.....
@....@.@@@.@.@@.@.@@
@@.@@...@...@.@@...@
@@..@.@@.@.@...@@.@@
@.@..........@...@@@
....@@.@.@@@@..@.@@@
11
0 11 0
16 18 0
19 8 0
10 13 0
4 18 1
12 10 1
17 4 1
19 6 1
3 3 2
0 3 2
11 9 2

0 11 0
13 3 0
5 7 0
14 0 0
9 8 1
8 19 1
19 8 1
12 2 1
10 4 2
12 5 2
8 5 2
