width 20
height 20
@@@.@...@@@.@@.@@.@.
@@..@.@.............
@@@.@.@.@@.@@.@@.@@.
.@@....@@@@...@@@.@.
....@.@.@@@@.@@@@...
@.@.@.....@..@@@@@@.
...@@.@.@@@@@@@@@...
@@@.@@....@@@@@@@.@.
....@..@.@.@@@@...@.
@.@.@.@.@...@@.@@..@
@@@.@.....@.....@.@@
@@....@.@@..@@.@.@@@
.@.@.@@..@.@.....@@@
.@..@@@@@.@.@@@@.@@@
..@..@@@............
.@.@@@@@@.@.@.@@.@@.
....@@@@...@@@@.@.@.
@@.@@.@.@.@.@.@....@
................@@@@
.@@.@.@.@.@.@@@..@@@
11
3 18 0
3 4 0
0 16 0
11 18 0
7 11 1
13 18 1
0 15 1
9 16 1
4 18 2
19 3 2
7 0 2

5 2 0
0 13 0
7 0 0
19 2 0
0 14 1
19 15 1
10 14 1
14 12 1
2 6 2
4 11 2
9 16 2
