width 20
height 20
@@..............@@..
@@..........@...@..@
@...................
...@.....@..........
............@.......
...@.@.@...@........
..@....@.@.@........
....................
............@.......
..@@....@.......@...
.....@........@.....
.........@..........
.....@..............
...@.....@..........
..............@..@..
...@................
.....@......@..@....
........@...........
@@.......@......@@..
@@@@...........@@@..
5
6 0 0
5 18 0
18 5 1
7 7 1
11 0 2

8 4 0
5 19 0
16 11 1
10 5 1
15 6 2
