width 20
height 20
@@..................
@@...@..............
@@............@.....
@@..@...@......@....
.....@..............
.........@..........
..@....@.......@....
..........@.........
..................@.
..@......@.........@
@.....@.....@......@
...........@........
.@...@...@...@.@...@
....................
..@.........@.@.....
...@..@......@..@...
....................
....@...............
....................
............@.......
13
16 16 0
2 2 0
0 13 0
10 13 0
16 1 0
11 10 1
7 4 1
9 11 1
6 11 1
11 0 2
9 1 2
6 19 2
14 12 2

14 17 0
2 12 0
8 4 0
15 8 0
1 17 0
16 9 1
12 15 1
17 18 1
17 0 1
3 18 2
18 18 2
19 0 2
4 0 2
