width 20
height 20
........@@.........@
.@..........@......@
....................
......@.........@...
@...........@.......
....................
@............@...@..
......@..@@......@..
.@............@.....
...@.@.....@........
...............@....
.......@............
.........@..........
....@.......@..@@...
...........@........
.....@..........@...
.@.......@.......@..
....@...............
.........@...@@.....
.....@.....@@@@.....
13
10 10 0
2 8 0
19 8 0
1 15 0
14 15 0
14 2 1
2 18 1
17 17 1
0 11 1
14 0 2
18 19 2
11 7 2
19 2 2

3 17 0
1 14 0
0 18 0
1 4 0
2 18 0
19 15 1
11 11 1
18 7 1
19 13 1
18 4 2
18 19 2
12 5 2
17 3 2
