width 20
height 20
......@.............
..@..@...@..@.......
....................
..........@..@.@....
....................
...@.....@.........@
.............@....@@
@......@......@...@@
@.................@@
.....@.@......@.....
....................
....@.@...@.........
..........@..@......
.@...@..............
....................
.....@........@.....
....@......@........
.......@.@..........
..@...@.............
@...................
13
5 5 0
8 16 0
4 13 0
4 14 0
2 6 0
2 8 1
15 11 1
11 14 1
19 13 1
0 3 2
7 3 2
15 0 2
12 4 2

19 0 0
12 7 0
19 3 0
3 14 0
19 17 0
4 3 1
1 3 1
2 0 1
0 2 1
6 2 2
3 19 2
0 9 2
0 3 2
