width 20
height 20
....................
....................
....................
............@..@....
......@.............
..............@.@...
.......@..@.........
................@...
....@...............
.............@......
...........@....@...
.....@..............
.......@..@..@......
....................
..............@..@.@
..@...@.............
..@@.......@.@...@..
...@................
..............@@....
......@......@@@@@..
4
11 3 0
8 19 0
6 12 0
19 17 0

9 2 0
16 0 0
4 12 0
15 7 0
