width 20
height 20
@......@@.....@..@@@
...@.............@@@
..@................@
......@.....@.......
.......@...@.....@.@
....@.@.......@....@
............@.......
.....@...@@@..@.....
.......@.@@.......@@
..@.........@..@...@
........@..@..@.....
.........@......@.@@
...........@..@...@.
...@.@.@............
....................
.......@.@..........
............@..@..@@
..@.....@.@.....@@@@
................@@@@
......@.........@@@@
4
13 10 0
13 15 0
9 18 0
14 8 0

13 7 0
0 1 0
9 18 0
1 1 0
