width 20
height 20
....................
......@.............
.............@......
.@................@.
.....@.@....@.......
...........@@...@...
....@...@..@........
................@...
....................
......@....@....@...
..@...............@.
.......@........@...
.@........@......@..
....................
...........@........
.@............@.@...
.............@.@....
....................
....................
......@@............
4
9 14 0
1 11 0
10 6 0
18 8 0

9 14 0
12 0 0
14 7 0
19 12 0
