width 20
height 20
......@@........@@..
.......@..@.........
...............@....
....................
...@.@.......@...@..
.........@....@.@...
....................
....@.@..@...@......
...............@....
......@....@........
@.........@.........
.@..@.......@..@....
....................
......@...@.......@.
.........@..........
............@.......
...........@..@.....
.....@...@..........
.............@.....@
.................@@@
5
11 10 0
13 17 0
15 0 0
17 16 0
13 8 0

14 9 0
11 3 0
9 19 0
13 9 0
10 15 0
