width 20
height 20
@...............@@@@
@..............@....
@...@....@....@.....
....................
......@....@.@......
................@...
......@.............
.........@......@...
...@.........@......
.......@............
...@....@...........
.@....@...........@.
.........@@...@.....
....................
....@.......@...@...
..................@@
...............@..@@
.......@..........@.
........@...........
...........@........
5
8 1 0
5 7 0
11 3 0
15 12 0
7 14 0

7 13 0
1 7 0
9 3 0
2 2 0
1 19 0
