width 20
height 20
..........@.........
.............@......
......@........@@...
..@............@@@@.
....@....@.@........
...................@
..............@.....
......@....@........
...@........@.......
@@...........@......
@@........@.........
@@....@..........@@.
@@...@..............
..........@.@....@..
..................@.
..........@.........
...............@...@
............@.@....@
...@@..............@
...@@.............@@
5
17 12 0
8 2 0
11 19 0
12 12 0
12 5 0

10 3 0
13 13 0
14 19 0
17 19 0
0 19 0
