width 20
height 20
@@@.@.@.@.@.@@@@@@@.
@@......@...@@@@@@..
..@.@.@...@.@@@@@@@.
@....@.@.@...@@.@.@.
@@.@@...@..@........
@....@.@.@.@.@.@.@.@
@@@.@.......@.@@@...
@@@@..@.@.@...@@@@.@
@@@..@.@.@@.@@@@@@.@
@@@.@....@@@.@@....@
@@@.@@.@..@....@@.@@
.......@@...@.@.@.@@
.@.@@.@@..@@.....@@@
@.@@@..@.@@@@.@@@@@@
..@@..@@..@@@@@@@@@@
.@...@@..@..@@@@@@@@
...@@@.@...@.@.@@@@@
.@..@...@@.@....@@@@
..@.@@@......@.@@@@@
.@@@@@@@.@@@..@@@@@@
10
1 14 0
8 13 0
17 4 0
7 17 0
16 4 1
12 4 1
2 16 1
8 15 2
19 2 2
15 17 2

1 18 0
19 3 0
10 3 0
15 3 0
13 13 1
11 18 1
8 6 1
7 15 2
15 12 2
2 17 2
