width 20
height 20
....................
.............@....@@
..................@.
..@.....@......@....
.......@@.@...@.....
.................@..
.....@.........@....
..........@...@.....
..................@.
.@.......@...@...@..
.....@........@.@...
....................
.@.....@........@.@.
...@.........@...@..
...............@.@..
....@..@............
................@...
....................
...........@..@.....
....@@@..@...@@@....
13
6 17 0
3 9 0
6 14 0
10 6 0
9 17 0
12 19 1
11 3 1
13 14 1
19 6 1
9 13 2
10 9 2
9 15 2
19 4 2

8 14 0
6 2 0
4 11 0
18 3 0
0 0 0
6 3 1
0 17 1
9 6 1
3 17 1
5 14 2
9 17 2
2 16 2
2 18 2
