width 20
height 20
..............@@@@..
....................
...@.............@..
.....@.@............
......@.....@..@....
................@...
...........@........
...@...@............
................@...
............@......@
....@..........@..@@
........@.....@..@..
.......@@...........
....@...@....@......
..........@.........
@...@...............
.......@........@...
..@.......@.........
..@.................
..@.........@.......
13
14 16 0
17 9 0
7 1 0
11 11 0
15 6 0
0 13 1
7 6 1
16 4 1
15 13 1
8 4 2
6 11 2
7 19 2
3 10 2

2 7 0
16 9 0
7 1 0
6 11 0
3 19 0
19 1 1
3 17 1
3 16 1
19 6 1
17 16 2
16 1 2
5 8 2
5 19 2
