width 20
height 20
....................
..@.................
.............@......
........@.......@...
.........@.....@....
....@.....@.........
.....@..............
..@@.......@...@....
@.@@....@..........@
@...................
.......@......@.....
........@...........
.....@..............
........@..@...@....
...@................
..@....@......@....@
.@.........@.....@..
....................
....................
..@@..@.............
2
4 13 0
15 19 1

11 18 0
14 19 1
