width 20
height 20
....................
......@..@...@......
....................
.@...............@..
...@..@..@..........
.....@........@.@...
............@.......
....@.@..@.......@..
......@@....@...@...
....................
.@..........@...@...
....................
.......@............
...@..........@.....
....@....@..........
.@......@.@....@.@..
...........@........
........@...........
............@.......
....................
2
8 10 0
16 6 1

18 0 0
6 11 1
