width 20
height 20
@@..@@...........@@@
@@..@@............@@
@@..@@@...........@@
..................@@
.............@....@@
...@....@..@........
....................
...@...........@....
.@..................
........@.....@.....
......@......@......
.......@....@.......
.............@....@.
...@........@.......
........@.@.........
......@.........@...
...@................
.@.....@.....@......
...........@@@......
..........@@@@......
2
2 17 0
11 15 1

4 5 0
5 15 1
