width 20
height 20
....................
....@.@..@..........
.........@..........
..................@.
...@..@..@..........
........@....@.@..@.
...@...@.@..@.......
...............@.@..
............@.......
.........@..........
....@...@...@.....@.
.....@.......@......
........@..@........
.@.......@..........
.@..................
......@............@
...@................
...........@........
.....@.....@@@@@@...
.......@...@@@@@@...
2
3 15 0
10 18 1

19 5 0
6 14 1
