width 20
height 20
.@@@.@@...@@@@.@.@@@
..@.....@..@......@@
.@.@.@@.@.@.@@.@.@.@
.......@....@@@@....
@@.@.@@.@.@@@@@.@@.@
@@@..@.......@..@..@
@@..@.@.@@.@..@..@..
@.@@.....@@@@.@.@.@.
@...@.@.@@...@@.....
..@....@...@....@.@.
@..@.@.@@@..@.@..@.@
@.@.@.@@..@@...@@...
..@......@..@.@@@@.@
@.@.@@@.@.@.....@@.@
....@.......@.@@...@
@.@@..@.@@.@@@.@@@..
..@@@..@@@@.@@..@..@
.@.@@@@.@.@....@.@..
............@@.....@
.@@.@@.@.@.@@@@.@.@@
5
5 14 0
17 14 0
7 18 1
7 8 1
18 18 2

15 10 0
0 17 0
16 1 1
7 6 1
4 1 2
