width 20
height 20
@..@...@@..@.@.@.@.@
@.@.@.@@@@.........@
......@@@..@.@@@.@@.
@.@.@....@..@@@.....
@@@@..@.@..@@@.@@.@.
@.@.@..@.@..@...@@..
@.....@....@.@.@.@.@
..@@@.@.@@...@......
.@.@.@@.@..@..@.@@.@
.@......@@.@.@.@@..@
..@.@.@..@@....@.@@@
.@...@..@.@.@@...@.@
...@..@.@.@@.@@@....
@.@@.@....@@.@...@@.
@@.@@@.@@@.....@@...
.@....@.@@@.@.@@@.@.
...@.@...@..@@.....@
.@.@.@.@...@.@@.@.@@
..@@@.@.@@.@.@...@.@
@............@.@....
5
18 11 0
18 0 0
1 10 1
18 16 1
18 19 2

4 9 0
11 7 0
1 10 1
19 5 1
1 2 2
