width 20
height 20
@@@@@@@@@@.@@@@@@@@@
@@@@@@@@@....@@@@@@@
@@@@@@@@@@.@.@@@@@@@
@@@@@@@...@@.@@@@@@@
@@@@@@.@.@.@..@@@@@@
@@@@@.......@.@@@@@@
@@@@@@.@.@.@@.@@@@@@
@@@@@...@@.@@.@@@@@@
@@.@.@.@@.....@@@@@@
@......@.@@.@..@@@@@
@@@.@.@..@@.@.@.@@@@
@@...@@@...@@.@..@@@
@@@.@@@..@@@....@.@@
@@...@..@.@@.@@....@
@@@.@.@.@.@@..@@@.@.
@@@.......@..@......
@@@.@.@.@..@.@@@.@@.
@@@@@@@@@.@@@@@@@...
@@@@@@@@@@@@@@.@.@@.
@@@@@@@@@@@@@@......
15
8 15 0
3 14 0
19 16 0
15 19 0
9 5 0
7 10 0
5 9 0
6 4 0
6 5 0
1 9 0
14 9 0
11 15 0
7 12 0
2 11 0
8 10 0

8 3 0
16 19 0
18 17 0
3 15 0
15 10 0
13 4 0
7 13 0
7 5 0
9 15 0
18 15 0
19 18 0
16 13 0
6 8 0
9 1 0
3 13 0
