width 20
height 20
@@@..@.@@@@@@@.@.@.@
@@..@..@@@@@@.......
@@@...@@@@....@.@.@@
@@..@@.@@.@@.@@.@..@
@@@..........@..@@@.
@@@@@.@.@@.@@.@@....
@@@@@@..@@.@..@..@.@
@@@@@.@...@@@...@.@@
@@@@@..@.@.@..@.@.@@
@@@@..@@.@.@@..@...@
@@@@@.......@.@.@.@@
@@@@@.@@@.@.....@..@
@@@@@@@.@..@@.@.@.@@
@@@@@.....@@@@.....@
@@@@@@.@@..@@@@.@.@@
@@@@@@@@@@.@@@@@..@@
@@@@@@@@@@@@@@@@@...
@@@@@@@@@@@@@@@...@.
@@@@@@@@@@@@....@@..
@@@@@@@@@@@@@.@...@.
15
4 2 0
10 8 0
14 7 0
17 19 0
2 3 0
15 8 0
18 3 0
6 4 0
15 1 0
13 8 0
15 6 0
16 5 0
13 19 0
18 0 0
17 5 0

13 2 0
19 4 0
6 6 0
16 1 0
19 19 0
9 13 0
19 1 0
5 11 0
5 1 0
11 11 0
10 6 0
16 5 0
17 7 0
11 2 0
6 0 0
