width 20
height 20
@@.@@@@@@@@@@@@@....
@@.@@@@@@@.@.@@@@@@.
@@..@@@@@@......@.@.
@..@.@@@@@@@@.@...@.
@@...@@@@@.@.@@.@...
@.@@..@@@@.......@.@
.....@..@..@.@.@@@@.
@.@.@@.@.@..@.@@@@@.
@@.......@.@..@@@@..
@@.@.@.@.@.@@..@@@@.
@@..@@@.......@@.@..
@..@@@@@@.@@.@.@.@@.
@@.@@@@@@.@@........
.....@@@@@@@.@.@.@.@
.@.@.@@@@@@@@.@@@@..
..@@@.@@@@@@@......@
.@@@@..@@@.@.@.@.@@@
.@@...@.@......@@@@@
..@.@.@...@.@@.@@@@@
.@@@....@..@@@@@@@@@
16
19 0 0
2 4 0
0 16 0
7 6 0
16 13 0
9 12 0
12 10 0
14 16 0
13 8 0
17 2 0
8 7 0
15 4 0
0 17 0
14 11 0
18 13 0
11 18 0

17 3 0
3 10 0
2 1 0
8 10 0
16 0 0
10 17 0
8 7 0
12 17 0
4 14 0
9 19 0
5 17 0
17 2 0
10 9 0
10 16 0
10 2 0
4 17 0
