width 20
height 20
@@@@@@@@@.@.@@@.@@@@
@@@@@@@@....@.@.@@@@
@@@@@@@@@.@...@.@@@@
@@@@@@@@.@@@@....@..
@@@@@@@..@@@@@@.@.@.
@@@..@@@.@@@@@@.....
@@..@.@..@@@@@@@@.@.
@@@...@.@...@@@.@.@.
@@@.@.@...@.@@..@.@.
@@.@....@.@@@@@...@.
.....@.@@.@.@.@.@@..
@@.@@.@@@........@@.
.......@@.@.@.@@..@.
.@.@@.@@@@.@.@...@..
@.@.@.@@@......@.@@.
@......@@.@@@.@@@...
..@@.@.@....@@@@@@@.
@.@.@.@@@.@@@@@@@@..
..@...@@....@@@@@@@.
@...@..@@.@@@@@@@@@@
12
13 14 0
5 19 0
11 0 0
8 6 0
17 9 1
7 8 1
8 5 1
8 3 1
10 16 2
5 8 2
10 7 2
4 12 2

6 19 0
5 19 0
3 19 0
8 5 0
5 18 1
14 14 1
15 3 1
8 4 1
4 18 2
19 3 2
10 11 2
17 12 2
