width 20
height 20
........@.@@@.@@.@@@
.@@@.@.@...@...@..@@
.@@@@..@.@.@@.@@.@@@
..@..@..@.........@@
.@.@.@@.@@.@.@.@@.@@
.....@@@@@@@@...@.@@
.@.@....@@@@.@@..@@@
.@..@.@.........@@@@
..@@.@@@.@@.@@@..@@@
@.......@.@@@@@@@@@@
@.@.@.@.....@@@@@@@@
@@@.@.@.@.@.@@@@@@@@
@@@@...@..@....@@@..
@@@@@.@@@.@.@.@.@.@.
@@@@@@@@@@@@......@.
@@@@@@@@@@@.@@.@@...
@@@@@@@@@.@...@...@@
@@@@@@@@....@.@.@.@@
@@@@@@@@@.@@.....@@@
@@@@@@@@@@@@@.@.@@@@
12
2 0 0
2 5 0
16 0 0
3 3 0
13 19 1
4 4 1
8 17 1
15 18 1
12 4 2
7 6 2
2 9 2
3 0 2

0 0 0
5 12 0
11 16 0
12 18 0
12 6 1
1 5 1
9 17 1
15 8 1
1 9 2
10 7 2
16 2 2
17 16 2
