width 20
height 20
.................@@@
...........@......@@
.......@@@@@........
.........@...@......
...............@....
....@..@....@.@.....
.@.@................
..@.........@.......
..........@..@...@..
....................
.....@..............
.......@...@........
........@...........
@...................
@...................
@.......@...@..@....
....................
.....@...@..@.......
......@@....@@@@.@..
.....@@@....@@@@@@@@
5
13 13 0
4 9 0
19 3 1
9 16 1
0 19 2

14 12 0
4 10 0
5 15 1
7 16 1
17 4 2
