width 20
height 20
...@@@@@@@@@@@@@@@@@
.@..@@@@@@.@..@@@@@@
..@..@@@@..@.@.@@.@@
@..@@.@.@@........@@
..@.@......@.@.@.@.@
@.....@.@.@@@@.@....
@@.@.@...@@....@.@@.
@@@@@@@.@.@.@.@.@@@@
@@....@@@.@..@@..@@@
...@.@.@....@@..@@@@
@.@.@....@@.@.@.@.@@
@.....@@...@@......@
..@.@@.@@.@.@.@@@@..
@..@...@@.......@@.@
@.@.@.@..@.@.@.@@@@@
@@..@.@.@..@@@@@@@@@
@.@.......@@@@@@@@@@
....@@.@.@@@@@@@@@@@
.@@...@...@@@@@@@@@@
...@.@@@.@@@@@@@@@@@
1
19 5 0

2 1 0
