width 20
height 20
@@@@@@@@@@@@@@@.@@@@
@@@@@@@@@.@@@...@@@@
@@@@@@@@..@@.@@.@@@@
@@@@@@.@@.@@....@@@@
@@@@@@.......@.@@@@@
@@@@@..@@@@@@.@@@@@@
@@@@.@..@@@@@.....@@
@@.....@@@@@.@@.@@@@
@@.@.@.@..@...@....@
.@@..@@.@.@.@...@.@@
....@.@.....@@@.@@.@
@@@.....@.@....@....
..@@.@@.@.@.@.@@@.@@
@.@...@@.@@.@..@...@
....@......@@.@.@.@@
@.@.@.@@.@@@@......@
@@@@....@@@...@.@.@.
@@@@@.@..@@.@.@@..@.
@@@@@@..@@@@@@@@@.@.
@@@@@@.@@@@@@@@@....
1
13 12 0

13 16 0
