width 20
height 20
@@@@@@@@@@@@@@@@@@@@
@@@@@@@@@@@@@@@@@@@@
@@@@@@@@@@@@@@@@@@@@
@@@@@@@@@@@@@@@@@@@@
@@@@@@@@@@@@@@@@@@@@
@@@@@@@@@@@@@@@@@@@@
@@@@@@@@@@@@@@@@@@@@
@@@@@@@@@@@@@@@@@@@@
@@@@@@@@@@@@@@@@@@@@
@@@@@@.@@@@@@@@@@@@@
@@@@......@.@.@@@@..
@@@@@@.@@.....@@@@@.
@@@@@....@.@@@@@@@..
@@@@..@@.@@..@.@...@
@@@@@@@..@.@.....@.@
@@@@@@@@.....@.@..@@
@@@@@@@@.@@@..@..@@@
@@@@@@@@@@@@.@@@..@@
@@@@@@@@@@@@..@.@..@
@@@@@@@@@@@@@....@@@
1
6 11 0

18 14 0
