width 20
height 20
..@.@@.@..@.....@.@@
.@@.@@...@..@.@@@..@
....@@.@@..@...@@.@.
@.@@@...@.@@@@......
.....@.@.@@@@@.@.@.@
.@@@.......@@..@..@.
@@@..@@.@@....@..@..
@@..@@..@..@.@@@...@
@@@.@@@..@.@@@@@@@.@
@@..@@@.@@@@@@@@@...
@@@..@.....@@@@@@@.@
@@@.@@@.@.@@@@@@@@@@
@@@@@@@@@..@@@@@@@.@
@@@@@@@.@.@.@@.@@...
@@@@@@.........@.@.@
@@@@@.@.@.@@@@.@....
@@@@.....@@@@@...@.@
@@@@@@@.@@@@@@@@..@@
@@@@@@...@@@@@@@@.@@
@@@@@@@.@@@@@@@@@@@@
1
9 11 0

18 12 0
