width 20
height 20
.....@@@@@@@@@@.@@@.
.@.@..@@.@@@.....@..
@.@@.@.@.@@@.@.@..@.
.........@@@@.@..@@.
@.@@.@.@....@...@...
...@@...@@@.@@@...@.
@.@@.@@@@..@@@@.@..@
......@@..@....@..@@
.@@@.@@.@..@@.@.@..@
..@@......@.@.@.@.@@
.@...@@@@..........@
.@@@@.....@@@.@.@.@@
.@..@.@.@.@.@.@@@...
...@...@@...@.@@@.@@
@@.@@.@@@@.@@.@@....
@@.@@@@@@@@@....@.@@
@@@@@@@@@@@@@.@@@@@@
@@@@@@@@@@@@@@@@@@@@
@@@@@@@@@@@@@@@@@@@@
@@@@@@@@@@@@@@@@@@@@
12
8 9 0
3 12 0
12 7 0
12 10 0
12 2 1
10 6 1
2 14 1
11 9 1
8 3 2
10 10 2
7 8 2
0 12 2

4 8 0
3 12 0
13 9 0
0 13 0
14 15 1
10 10 1
2 14 1
13 13 1
19 4 2
13 1 2
7 5 2
8 7 2
