width 20
height 20
@@@@@@@@@@@@@@@@@@@@
@@@@@@@@@@@@@@@@@@@@
@@@@@@@@@@@@@@@@@@@@
@@@@@@@@@@@@@@@@@@@@
@@@@@@@@@@@@@@@@@@@@
@@.@@@@@@..@@@@@@@@@
...@@@@@@@..@@@@@@@@
.@..@@@@@@.@.@@@@@@@
@..@@@@@@.....@@@@@@
.@.@...@..@.@@@@@@@@
.....@@@@..@@@@@@@@@
@@.@...@.@.@@@@@@@@@
@@@@.@......@@@@@@@@
@@..@@.@@.@.@@@@@@@@
@@@.....@.@..@@@@@@@
@@.@.@.@@@..@@@@@@@@
@@.@..@.@@.@@@@@@@@@
@...@....@@@@@@@@@@@
@@@...@.@@@@@@@@@@@@
@@@@.@..@@@@@@@@@@@@
12
2 13 0
4 12 0
10 7 0
3 17 0
2 5 1
8 11 1
2 6 1
6 11 1
7 19 2
4 9 2
10 5 2
9 8 2

0 6 0
5 11 0
1 10 0
4 12 0
0 7 1
1 6 1
2 13 1
4 11 1
6 13 2
11 9 2
9 8 2
9 5 2
