width 20
height 20
..@@.@@@@@@@@@@@@@@@
@.....@@@@@@@@@@@@@@
..@.@..@@@@@@@@@@@@@
@..@..@@@@@@@@@@@@@@
@@..@..@@@@@@@@@@@@@
@@@@..@.@@@@@@@@@@@@
@.@@@.@.@@@@@@@@@@@@
...@....@@@@@@@@@@@@
@.@@@.@..@@@@@@@@@@@
...@.@..@.@.@@@@@@@@
.@@....@@....@@@@@@@
..@@.@....@@..@@@@@@
.@@@..@.@@@@@.@@@@@@
...@@.@..@@@@@@@@@@@
.@@.@.@@@@@@@@@@@@@@
.......@@@@@@@@@@@@@
.@.@@.@@@@@@@@@@@@@@
..@...@@@@@@@@@@@@@@
.@@.@@@@@@@@@@@@@@@@
@@@@@@@@@@@@@@@@@@@@
5
5 2 0
7 11 0
3 1 0
11 10 0
0 7 0

2 1 0
7 6 0
6 9 0
10 10 0
1 2 0
