width 20
height 20
@@.@......@@@@@.@@@@
@..@@.@.@.@@@@...@@@
..@@@@@@...@@.@.@.@.
@..@@@..@.@@......@.
..@.@.@.@.@..@@.@.@.
@..........@.@.@@...
.@@.@.@.@@.......@.@
.@...@@@@@@.@@@@..@.
.@@@..@@@@@.@@@..@..
..@@@@@@@@@@@@@@..@.
@...@@@@@.@.....@.@.
..@..@@.....@.@.....
@.@@@..@.@@..@..@.@@
@.....@@.@.@@@.@@@@@
..@.@....@.@.@..@@@@
@.@@@@.@...@...@@@@@
@@@@@...@@@..@.@@@@@
@@@@@@.@@.@.@@@.@@@@
@@@@@.....@......@@@
@@@@@@@.@.@.@.@.@@@@
5
19 5 0
11 11 0
17 7 0
7 11 0
1 15 0

7 18 0
4 13 0
9 10 0
11 11 0
7 1 0
