width 20
height 20
.................@@@
...................@
.@.........@........
.....@..............
....................
..@......@..@...@...
.................@..
....................
...@.@.@............
....@...............
.............@......
......@..........@..
..............@.....
.....@..............
.@........@..@.@....
....................
.........@..........
..........@.........
............@..@....
....................
15
18 6 0
18 4 0
3 4 0
8 15 0
15 7 0
4 19 1
10 4 1
17 8 1
15 12 1
18 9 1
19 5 2
3 10 2
0 4 2
9 3 2
12 2 2

8 3 0
15 7 0
3 4 0
3 1 0
1 18 0
19 11 1
2 8 1
4 6 1
9 12 1
5 16 1
9 11 2
9 3 2
2 2 2
7 4 2
0 19 2
