width 20
height 20
@......@............
@...................
@....@.......@......
@.......@........@..
@......@......@.....
@...................
....@..@......@.....
......@@............
..@..@....@.........
..........@....@....
..@.@..@@@@.........
.......@@@@.........
............@....@.@
.........@.....@....
....................
............@.......
.@...@..............
@@..............@...
@@@@@.............@.
@@@@................
13
12 0 0
19 9 0
2 15 0
3 13 0
16 19 0
14 14 0
13 11 0
12 6 0
7 2 0
19 5 0
11 8 0
15 5 0
10 7 0

10 0 0
11 8 0
18 13 0
5 12 0
15 3 0
2 7 0
3 0 0
2 13 0
18 14 0
18 5 0
19 0 0
3 7 0
0 12 0
