width 20
height 20
....................
............@.......
@@......@..@........
@........@....@...@.
@..@.@......@..@....
@........@..........
......@...........@.
..........@..@......
....@.@...........@.
....................
...........@.@......
.........@....@.....
....................
........@...@....@..
..@..........@...@..
.......@............
..........@.........
.@...........@@.....
...@.........@......
................@.@@
5
7 4 0
11 5 0
6 17 1
2 8 1
6 16 2

19 13 0
11 4 0
10 10 1
1 0 1
17 8 2
