width 20
height 20
.@@.......@...@@@..@
....................
............@.@....@
...................@
..@@.......@.@.@....
...@.....@..........
.@.@..@..........@..
............@..@....
..........@.........
....................
...@......@.........
.......@............
.@.............@....
...@.....@.......@..
....................
.........@..@...@...
..@.................
...@...@............
....................
..........@...@@....
8
6 19 0
6 14 0
5 13 0
8 5 0
19 17 0
5 4 0
0 0 0
2 2 0

3 15 0
4 2 0
7 14 0
13 6 0
7 1 0
5 5 0
19 15 0
18 0 0
