width 20
height 20
@@.@.@@....@@@@@@@@@
@@......@.@@@@@@@@@@
@@@@.@.@...@@@@@@@@@
@@@...@@@@.@@@@@@@@@
@@.@.@@@...@@@@@@@@@
@@......@@@@@@@@@@@@
@..@.@.@@@@@@@@@@@@@
@@..@@.@@@@@@@@@@@@@
@.@@@..@@@@@@@@@@@@@
@.@@.@.@@@@@@@@@@@@@
........@@@@@@@@@@@@
@.@@.@@..@@@@@@@@@@@
@@....@.@@@@@@@@@@@@
@.@.@@..@@@@@@@@@@@@
....@..@@@@@@@@@@@@@
@@.@@@..@@@@@@@@@@@@
.....@@.@@@@@@@@@@@@
@.@@@..@.@@.@@@@@@@@
......@@.....@@@@@@@
.@.@@....@.@..@@@@@@
4
5 1 0
0 14 0
4 16 0
8 19 0

9 2 0
7 0 0
4 16 0
2 18 0
