width 20
height 20
@@@@@@@@@@...@@@@@@@
.@.@@@@@@@@.@@@@@@@@
....@@@@@.....@@@@@@
.@.@@@@@@@@.@...@@@@
..@.@@@@@@@@@@.@.@@@
.@..@@@@@@.@@....@@@
...@.@.@@...@.@.@@@@
.@...@..@@@....@@@@@
@.@@.@.@.@..@@@..@@@
...........@.@.@..@@
@@@.@.@.@@.......@..
@@@..@@.@@.@.@.@...@
@@@@@....@..@..@.@..
@@@@@.@.@@@..@.@.@.@
@@@@..@@@@@.@@.@@...
@@@..@.@@@@@..@..@.@
@@@@.@.@@@@.@...@@.@
@@@@@.........@.....
@@@@@@@.@.@.@@@@.@.@
@@@@@@@@@@..@@@@.@..
4
16 9 0
16 11 0
15 15 0
1 4 0

0 1 0
4 6 0
12 17 0
18 18 0
