width 20
height 20
....................
....................
@......@............
.........@....@.....
....................
@@@@................
@@@.................
.....@.....@.....@..
.........@..@.......
......@......@......
.......@............
..@..........@......
.......@............
.........@..@...@...
..@....@............
.....@..............
.................@..
.....@...@......@...
...@...@............
..............@.....
4
8 14 0
15 19 0
11 14 0
17 19 0

14 6 0
5 0 0
10 12 0
6 18 0
