width 20
height 20
....................
..........@......@..
.@..@..............@
...........@...@....
......@.......@.....
....................
................@...
...@.@..............
..............@.....
....................
....@....@...@......
@..@.....@@......@..
....................
@..@....@...........
....................
........@......@....
...@...............@
.............@.....@
.................@@@
..................@@
4
11 12 0
11 14 0
7 12 0
6 7 0

19 1 0
9 12 0
15 4 0
0 8 0
