width 20
height 20
....................
..@......@....@.....
...............@....
..........@.....@...
........@...........
....@.......@......@
.....@..@.........@@
.............@.....@
.@.@...............@
@....@......@...@...
......@.....@.@..@..
..........@.........
.@...............@..
@..........@...@....
@...................
@...................
@......@..@...@.....
@..@@...............
....................
....................
4
2 13 0
18 12 0
12 19 0
13 11 0

14 9 0
0 1 0
17 13 0
3 9 0
