width 20
height 20
@@@................@
@@@.......@..@.....@
.........@..........
........@.@.........
@............@..@...
....................
@@..............@@..
@..@....@.......@@..
@...................
@..@...@.......@.@..
.........@.@........
...@.........@..@...
....................
.....@...@..........
...@................
..@...........@.....
......@......@......
.................@..
......@.........@...
........@@@.........
4
19 2 0
0 13 0
6 3 0
0 19 0

3 12 0
18 16 0
3 4 0
5 5 0
