width 20
height 20
.....@@@@@......@@@@
.@........@.....@@@@
....@........@......
...............@....
.......@............
...@................
..@.......@.........
.........@.....@....
.....@......@...@...
....@...............
...........@........
....................
........@.....@...@.
@....@..............
@...................
@........@...@.@....
....@...............
.......@.@.....@....
.@..................
....................
4
6 14 0
19 15 0
0 9 0
15 13 0

16 3 0
5 3 0
16 18 0
5 11 0
