width 20
height 20
...................@
..@....@............
........@...........
.......@............
.@.........@.....@..
.......@.@........@.
...........@.@......
.....@..........@...
.............@......
....@...............
.......@.........@..
..........@.........
@@@...........@..@..
@@@@.@...........@..
@@@@................
........@...........
............@.@.....
.................@..
.............@......
........@....@@.....
4
4 13 0
19 2 0
1 17 0
19 18 0

8 6 0
19 5 0
13 0 0
9 4 0
