width 20
height 20
...@@@.@....@@......
...@@@..............
...@................
.................@..
...@......@.........
..................@@
.....@.........@..@@
...@......@.......@@
.......@.@..........
....@...@.......@...
...............@....
.@..@...............
....................
....................
....@.@....@........
.@......@.....@....@
...................@
.....@..............
....................
.@@@................
11
13 9 0
5 15 0
14 11 0
6 2 0
12 3 0
5 2 0
18 2 0
1 16 0
2 7 0
15 3 0
12 9 0

5 5 0
16 2 0
5 10 0
19 18 0
18 12 0
17 17 0
1 8 0
5 8 0
17 19 0
13 18 0
1 10 0
