width 20
height 20
........@@..@.......
..............@.....
....................
....................
.......@.......@....
......@...@.@.......
....@...............
..@...@.......@....@
...................@
.....@..............
................@...
.......@.........@.@
..........@.........
................@...
.....@....@..@......
....@...@.......@...
@@@.................
@@@....@......@....@
@@.................@
@@.................@
2
18 7 0
14 11 1

18 3 0
1 1 1
