width 20
height 20
..........@.........
@......@.....@.@....
...@.@........@.@...
.@..................
@....@....@..@......
.................@..
.......@............
..........@....@....
.@..................
....................
........@.....@.....
...........@........
..@......@..........
....@.@....@..@..@..
.............@......
.@.......@.......@..
.......@..........@.
......@...@.@.......
....................
.......@....@.@.....
11
5 6 0
3 5 0
12 13 0
1 10 0
16 16 1
6 6 1
7 2 1
1 16 1
15 14 2
2 6 2
9 4 2

16 6 0
0 12 0
11 2 0
12 11 0
5 6 1
17 18 1
13 19 1
16 15 1
0 0 2
18 17 2
0 19 2
