width 20
height 20
@@@@@..@@@....@@@@@.
@@@@..@@@.@@@..@@@@.
@@@.@.@@...@.@..@@@.
@@.....@.@@....@.@..
@.@.@@......@@.@..@.
......@.@.@.@.@..@..
@.@.@@...@@.....@.@.
...@..@.@.@@.@@.....
@.@@.@@....@.@.@@@@.
@.@..@..@.@@@@...@..
....@..@..@....@...@
@.@@@@..@@.@.@..@@..
...@@@@.@....@.@...@
.@@.@@.@..@@@@@@@.@.
@.@......@@@@@@@@...
@...@.@.@@.@.@@@.@.@
..@.@..@.....@@....@
@..@..@.@@.@....@@@@
..@@@.....@..@@...@@
@...@.@.@..@...@.@@@
4
2 3 0
10 0 0
12 17 0
1 5 0

10 15 0
0 16 0
4 8 0
7 6 0
