width 20
height 20
@@@@@@.@.@.@.....@@@
@@@@@@.......@.@..@@
@@@@@.@@@@.@..@@.@@.
@@@@@..@@...@@@@..@.
@@@@..@@@@.@..@..@@.
@@@@@..@@..@.@@@....
@@@@@.@..@....@..@.@
@@.@@...@.@.@@@@..@@
......@.....@@@@.@@@
.@@.@.@@.@.@.@.@.@..
..@..@@..@@....@...@
.@@.@@@@...@.@...@..
..@@@.@.@.@@.@@.@@.@
.@@@....@@....@@...@
.@@@.@.@@@@.@@...@.@
@@@@..@@@@..@..@..@@
@@@..@.@.@.@@@.@.@@@
@@@@.......@@@@....@
@@@@@.@.@@.@@@@@.@@@
@@@@..@@...@@@@@@@@@
15
13 13 0
12 12 0
17 7 0
8 8 0
1 8 0
13 15 0
16 9 0
16 4 0
10 17 0
9 19 0
18 17 0
10 2 0
10 5 0
6 7 0
13 2 0

8 9 0
0 14 0
0 12 0
17 10 0
19 2 0
8 11 0
11 8 0
18 11 0
8 10 0
16 10 0
5 5 0
12 0 0
5 4 0
12 1 0
12 12 0
