width 20
height 20
@@@@@@@@@@@@@@@@@..@
@@@@@@@@@@@@@@@..@..
@@@@@@@@@@@.@..@...@
@@@@@@@@@@....@..@.@
@@@@@@@@@@@.@.@.@...
@@@@@@@@@@@@....@@@.
@@@@@@@@@@@@@.@@.@.@
@@@@@@@@@@@@.......@
@@@@@@@@@@@@.@@.@.@@
@@@@@@@@@@@@@@@@...@
@@@@@@@@@@@@@@@@@.@@
@@@@@@@@@@@@@@@@....
@@@@@@@@@@@..@@..@.@
@@@@@@@@@@@@....@@@@
@@@@@@@@@@@@.@@..@@@
@@@@@@@@@@@@@...@@@@
@@@@@@@@@@@@..@.@@@@
@@@@@@@@@@@@@..@@@@@
@@@@@@@@@@@@..@@@@@@
@@@@@@@@@@@@@@@@@@@@
15
13 3 0
18 2 0
15 4 0
11 2 0
14 17 0
18 6 0
13 5 0
12 12 0
11 12 0
16 3 0
16 7 0
16 2 0
17 9 0
17 11 0
17 0 0

16 14 0
12 12 0
18 0 0
15 13 0
12 8 0
15 16 0
14 13 0
13 6 0
16 12 0
19 11 0
17 4 0
12 16 0
13 16 0
17 7 0
18 2 0
