width 20
height 20
@..@@@@.@.@@@@@@@@@@
.@.@@@@....@@@@@@@@@
....@...@@.@@@@@....
.@@@..@@......@..@.@
.@@@@@@@@.@.@..@..@@
.....@.....@@@.@.@@@
@@.@@.@.@.@.@.@..@@@
@@....@@........@@@@
@@@.@@.@.@.@.@@..@@@
@........@@.@...@@@@
@@.@@@.@....@@.@.@@@
@...@@..@.@..@.@.@.@
@@.@...@@@@@@@.....@
@@..@@..@@.@@.@@@.@@
@@@.@@@@.@.@@.....@@
@@@@@@@.....@.@@.@@@
@@@@@@@@.@@...@.@@@@
@@@@@@@...@@@....@@@
@@@@@@@.@..@..@.@@@@
@@@@@@@@..@@@..@@@@@
15
16 3 0
8 7 0
10 14 0
14 7 0
15 17 0
0 4 0
9 4 0
4 7 0
13 17 0
6 9 0
9 0 0
10 3 0
12 11 0
9 18 0
2 0 0

16 12 0
8 17 0
7 18 0
16 15 0
0 5 0
7 15 0
8 7 0
5 6 0
17 13 0
18 2 0
15 16 0
10 8 0
13 17 0
1 5 0
14 14 0
