width 40
height 40
.................@.@@@@@................
.................@.@..@@................
@.........@..............@..............
.............@@.................@...@...
.....@@.@..................@.@..........
@..@.@.............@....................
................@....@......@..@........
...@.......@.@.....@........@........@..
.@@......@.@...............@............
@@..............@.......................
@@@....................@....@..@....@...
@@@......@..............................
@@@...@...............@.....@...........
....@........@.@.....@.@...@.@...@......
............@............@.....@....@...
.....@..........@...........@.@.........
...@...@........@.....@.@.........@.....
.........@.@..@...@.....................
.....................@.@.@.....@...@....
..........@........@............@.......
...@........@....@..........@...........
..............................@.........
............@.@........@.........@......
..@.......@..@..@.@.......@.......@...@.
.......@....................@..@........
.....@..................................
@..............................@.......@
@..@..................@.......@........@
.....@..@.....@....@.......@......@....@
..........@.........@@..@....@..@......@
.@..@.@...................@............@
...........@....@......@..............@@
......@..............@......@....@.....@
..............@........@.@...@..........
.@.......@..............@...............
............@.............@.......@..@..
....................@@...........@.....@
...@.@..............@@..........@.......
.......@............@@@.................
......@........@@@@@@@.......@@@@.......
11
5 21 0
18 14 0
3 3 0
1 20 0
24 31 1
3 32 1
6 27 1
34 25 1
6 22 2
37 19 2
7 39 2

29 35 0
26 26 0
37 39 0
36 5 0
7 32 1
3 19 1
17 26 1
27 17 1
6 27 2
37 25 2
29 3 2
