width 20
height 20
@..................@
.............@......
.......@............
................@...
......@..@.....@....
.@......@.......@...
....................
...@.....@.......@..
.......@...@....@...
.........@..........
..@@.@..............
...@.......@........
.................@..
........@.........@.
..@........@...@....
....................
.......@.@.....@....
.....@..............
.@...........@.....@
...................@
12
10 19 0
6 19 0
5 6 0
7 14 0
12 3 1
3 12 1
6 14 1
12 17 1
19 12 2
11 2 2
2 0 2
1 19 2

11 19 0
12 16 0
15 9 0
18 1 0
7 12 1
10 0 1
13 7 1
11 13 1
13 6 2
10 3 2
6 3 2
1 19 2
