width 20
height 20
..................@@
..................@@
...............@..@@
........@.@...@....@
...@.....@.@.......@
.......@......@....@
..@...@.............
.........@.@@..@....
...............@....
....................
...............@....
.....@..@...@.......
..................@.
....@.@..@.@..@.....
....................
.@..@...............
...........@........
.......@.......@....
.@@.................
....................
12
14 15 0
13 15 0
2 13 0
12 1 0
2 4 1
12 15 1
4 7 1
8 13 1
5 13 2
3 12 2
13 5 2
14 16 2

16 2 0
14 16 0
4 8 0
5 1 0
8 18 1
1 1 1
10 12 1
16 6 1
19 7 2
1 13 2
8 1 2
19 18 2
