width 20
height 20
.........@.@@.@@@@@@
.@.@@.@@.@.@...@@@@@
@..@@@@......@@.@@@@
.@..@@@@.@.@.....@@@
.@@@@@@@@...@@@@.@@@
.@.@.@..@@.@..@@.@@.
.......@.@...@....@.
.@.@.@.@...@.@@.@...
..@@@....@@..@.@..@@
@@@@@@@@@@@@....@...
@@@@@@@@@@@@@@.@@.@.
@@@@@@@@@@@@@.@@@.@.
@@@@@@@@@@@@...@...@
@@@@@@@@@@@.@.@.@@.@
@@@@@@@@@@.........@
@@@@@@@@@@@@.@@@.@..
@@@@@@@@@@@@..@...@.
@@@@@@@@@@@@@@@@@@..
@@@@@@@@@@@@@@@@..@.
@@@@@@@@@@@@@@@@@...
3
14 3 0
5 8 0
10 0 0

10 2 0
12 3 0
1 8 0
