width 20
height 20
@@.@@....@.@.@.@.@..
@....@@.@..........@
@@@@....@.@@.@.@.@.@
@@@@.@@@..@.@@@@@...
@@...@@@.@..@@@@@@.@
@@@@...@..@..@@@@@@@
@@@..@..@.@.@@@@@@@@
@@@@..@.....@@@@@@@@
@@@@@@..@@.@@@@@@@@@
@@@@.@.@.@@...@@@@@@
@@@....@...@.@.@@@@@
@@@@.@...@......@@@@
@@@@@@.@.@.@.@.@@@@@
@@@@..@..@@@.@@@@@@@
@@@@@...@@@@@@@@@@@@
@@@@@@.@@@@@@@@@@@@@
@@@@@@@@@@@@@@@@@@@@
@@@@@@@@@@@@@@@@@@@@
@@@@@@@@@@@@@@@@@@@@
@@@@@@@@@@@@@@@@@@@@
3
5 5 0
13 1 0
7 11 0

4 13 0
7 14 0
16 1 0
