width 20
height 20
@@@@@@@@@@@@@..@@@@@
@@@@@@@@@@@@@.@@@@@.
@@@@@@@@@@@@@.@@@@..
@@@@@@@@@@@@@.@@@..@
@@@@@@@@@@@@@.@@.@..
@@@@@@@@@@@@.......@
@@@@@@@@@@...@.@@@..
@@@@@@@@@.@.@.@....@
@@@@@@@...@.@...@.@@
@@@@@.@@.@.@@@.@..@@
@@@@..@........@@..@
@@@@@...@.@.@@@.@@.@
@@@@@@@@@@........@.
@@@@@@@@@@@.@@@.@...
@@@@@@@@@@@@..@..@.@
@@@@@@@@@@@@.@..@@@@
@@@@@@@@@@@@...@@@@@
@@@@@@@@@@.@.@.@@@@@
@@@@@@@@@..@..@@@@@@
@@@@@@@@@@...@@@@@@@
3
13 3 0
19 2 0
13 5 0

10 17 0
14 0 0
17 5 0
