width 20
height 20
@...@@...@@@@@@@...@
@.@@.@@.@.@@@@@..@@.
...........@@@..@@@.
@.@.@.@@@.@.@.@.....
..@@.@@@@......@@@.@
@.....@@@@.@@.@@@...
@.@@.@@.@@@.......@@
@@.........@.@.@.@@@
@@@@.@.@.@.@@..@.@@@
...@@@@@.@@.@@@@.@@@
.@@@@@@@@.@......@@@
..@@@@@@....@.@.@@@@
.@.@@@.@@.@@@@..@@@@
............@@@.@@@@
@.@.@.@.@.@@@@..@.@@
@@@@.@...@@@@@@.....
.@.@...@.@@@@@@@@.@.
...@.@@@@@@@@@@@@@@.
@@....@@@@@@@@@@@@@@
@@.@.@@@@@@@@@@@@@@@
18
18 0 0
18 3 0
9 10 0
3 0 0
6 12 0
0 17 0
0 9 1
3 5 1
10 4 1
6 7 1
6 0 1
6 15 1
15 13 2
5 18 2
16 0 2
4 13 2
15 2 2
1 13 2

7 7 0
14 8 0
9 2 0
4 7 0
15 1 0
5 2 0
2 18 1
16 10 1
11 13 1
2 19 1
5 16 1
15 11 1
4 5 2
3 3 2
12 4 2
10 5 2
17 3 2
16 3 2
