width 20
height 20
..............@.....
........@...........
....................
.@..................
..@...........@...@.
.......@........@...
......@......@......
.............@......
.......@..........@.
......@....@....@..@
...@......@@.@...@..
....................
......@..@..........
.............@.@....
.......@............
............@.......
.................@.@
.......@@...........
..@.@......@..@.....
@@@...@@............
2
19 8 0
15 14 0

3 15 0
1 0 0
