width 20
height 20
@@@@@@@@@@@@@@@@@@@@
@@@@@@@@@@@@@@@@@@@@
@@@@@@@@@@@@@@.@...@
@@@@@@@@@@@@@..@.@@@
@@@@@@@@@@@@@@.@...@
@@@@@@@@@@@....@.@..
@@@@@@@@@@@@.@.@@.@.
@@@@@@@@@@@@.@......
@@@@@@@@@@@@@@.@.@@.
@@@@@@@@@@@@@@@....@
@@@@@@@@@@@@@@.@.@..
@@@@@@@@@@@@@@...@.@
@@@@@@@@@@@@@.@.@.@@
@@@@@@@@@@@@..@....@
@@@@@@@@@@@@@..@@.@.
@@@@@@@@@@@@@@......
@@@@@@@@@@@@@@@.@.@.
@@@@@@@@@@@@@@@@@@..
@@@@@@@@@@@@@@@@@@@.
@@@@@@@@@@@@@@@@@@@@
7
14 14 0
14 11 0
18 4 0
14 15 0
14 8 0
12 7 0
19 5 0

14 11 0
14 10 0
13 13 0
18 5 0
16 4 0
16 13 0
18 17 0
