width 20
height 20
.@@.@@..@@@@@@@@@@@@
.......@.@.@@@@.@@@@
@@@.@@...@..@.@.@@@@
@@.@...@..@......@.@
@..@.@@.@...@.@@....
..@.@.....@@@@@@.@.@
@.....@.@.@.@..@@...
..@.@.@..@@.@.@...@.
@.@@@@@.@.@.@..@.@@.
..@...@.......@@@..@
@@.@@...@.@@.@@@.@..
.@....@@@@....@..@.@
...@@.@@@@@@.@@.@...
@.@@@.@@.@.@......@@
@.@@.@.@....@.@@@@@@
..@@.....@@.@@@@@@@@
@....@.@..@@@@@@@@@@
@@@.@@@@.@@@@@@@@@@@
@@@@@@@..@@@@@@@@@@@
@@@@@...@@@@@@@@@@@@
7
3 0 0
17 9 0
5 15 0
17 7 0
8 17 0
9 6 0
15 2 0

3 0 0
7 5 0
8 3 0
6 1 0
8 17 0
11 15 0
5 6 0
