width 20
height 20
@.@.@.@...@@@@@@@@@@
......@.@...@...@@@@
.@.@@....@@@@@@..@@@
@@@...@.@@@.@@@.@.@@
@@@@.@.@@@....@...@@
@@@@......@@@.@.@@..
..@..@.@.@@@.......@
@..@@.@..@@@@.@.@@..
@.@@@..@.@@....@...@
......@@....@.@@.@..
.@.@.@...@@.@...@..@
..@....@.@@..@@@.@..
@.@@@.@@@@@.@......@
@...@@@@@@@@@@@.@.@@
..@.@@@@@@@@@@...@@@
.@@@@@@@@@@@@@@.@@@@
..@@@@@@@@@@@@@@@@@@
.@@@@@@@@@@@@@@@@@@@
@@@@@@@@@@@@@@@@@@@@
@@@@@@@@@@@@@@@@@@@@
7
4 9 0
5 2 0
8 2 0
1 1 0
4 3 0
15 6 0
3 11 0

18 11 0
16 12 0
15 14 0
13 10 0
0 17 0
16 2 0
9 9 0
