width 20
height 20
@...@@@@@@@........@
@@@...@@@@@@@.@.@@..
@.@.@@.@@@@@@.@@@@.@
........@@@@@@......
@.@@.@.@@@@@@@.@.@.@
@@@@@...@@.@@.@@@..@
@@@@..@........@.@..
...@@..@@.@.@@...@.@
@.@@.@.@.@.@...@....
..@.........@.@..@.@
@..@.@@.@.@..@@@..@@
@.@..@@@..@.@@@..@@@
....@.@@@.@.@@@.@@@@
@.@....@@@@@@@@@@@@@
@@@@@.@@@@@@@@@@@@@@
@@@@@@@@@@@@@@@@@@@@
@@@@@@@@@@@@@@@@@@@@
@@@@@@@@@@@@@@@@@@@@
@@@@@@@@@@@@@@@@@@@@
@@@@@@@@@@@@@@@@@@@@
5
16 3 0
10 9 0
15 3 1
18 8 1
3 13 2

8 6 0
6 8 0
10 5 1
1 8 1
6 9 2
