width 20
height 20
................@@..
....................
....@..@.........@..
...................@
......@...........@.
....@........@...@..
...@.......@........
....................
..@..........@.@....
@..@.......@........
.......@............
.............@...@..
.......@..........@.
@...@......@.@....@@
@......@....@.......
@...................
....................
....................
...@.....@..........
....................
3
6 1 0
10 5 1
14 12 2

19 14 0
15 16 1
5 2 2
