width 20
height 20
@@@.........@..@@...
@@@............@....
@@@............@....
@.@....@.........@..
@........@..........
@@@@..@...@..@...@@@
@@@@..............@@
........@........@@@
..........@......@@@
.....@..........@@@@
...........@.....@@@
..@.@.@.............
.........@..........
.....@..@...@.......
..@............@@...
............@.......
....@...@....@......
.................@..
.........@..........
....................
2
4 18 0
3 10 1

14 0 0
19 1 1
