width 20
height 20
....................
....................
........@...........
@@.@@...............
@..@@.@........@@.@.
....@...............
....................
.........@..@.@.....
........@...........
......@.........@...
...@................
......@......@......
....................
..........@.....@...
......@.@...........
...........@.@..@.@.
.........@..........
........@..@........
................@...
....................
2
10 19 0
17 14 1

9 18 0
0 17 1
