width 20
height 20
@@@@@@..@.@@.@.@@@..
@@@@@@@.........@@.@
@@@@@@@@.@@.@.@@.@..
@@@@@@@....@.....@.@
@@@@@@@.@.@@@@.@....
@@@@@@@@..@.....@.@@
@@@@@@@@@@@@@.@@.@@@
@@@@@@@@@@@@..@..@@@
@@@@@@@@@@@@@...@.@.
@@@@@@@@@@@@@.@.....
@@@@@@@@@@@@@..@.@.@
@@@@@@@@@@@...@@@@@@
@@@@@@@@@@@.@.@@@@@@
@@@@@@@@@@...@@@@@@@
@@@@@@@@@@@.@@@@@@@@
@@@@@@@@@@@@@@@@@@@@
@@@@@@@@@@@@@@@@@@@@
@@@@@@@@@@@@@@@@@@@@
@@@@@@@@@@@@@@@@@@@@
@@@@@@@@@@@@@@@@@@@@
15
16 4 0
8 3 0
16 2 0
19 2 0
16 10 0
8 5 0
11 1 0
7 0 0
18 0 0
11 5 0
10 3 0
19 4 0
6 0 0
15 5 0
14 3 0

14 4 0
19 4 0
12 13 0
18 10 0
12 3 0
9 4 0
13 8 0
14 1 0
13 1 0
7 1 0
16 2 0
16 7 0
18 3 0
9 5 0
12 1 0
