width 20
height 20
.@@@...@.@.@@@@@@@@@
.@@.@.@@...@@@@@@@@@
....@..@.@.@@@@@...@
.@@..@....@.@@@..@@.
.@.@...@@.@...@@....
...@.@@@.@.@.@.@.@.@
@@@...............@@
@@@@.@@.@.@@.@.@.@@@
@.@.@@@@@...@@@@@@@@
.....@@@.@.@.@@@@@@@
@.@.@@.........@@@@@
...@@@@.@@.@.@.@@@@@
@.@.@....@@@..@@@@@@
......@.@@@@@@@@@@@@
@@.@@..@@@@@@@@@@@@@
.....@@@@@@@@@@@@@@@
.@.@@@@@@@@@@@@@@@@@
.@@@@@@@@@@@@@@@@@@@
@@@@@@@@@@@@@@@@@@@@
@@@@@@@@@@@@@@@@@@@@
19
9 7 0
12 7 0
10 0 0
0 5 0
14 5 0
16 2 0
10 1 0
11 10 1
0 2 1
5 4 1
5 14 1
4 13 1
9 8 1
15 6 2
1 15 2
13 6 2
14 11 2
0 3 2
8 0 2

2 9 0
15 6 0
0 15 0
0 4 0
4 9 0
4 13 0
0 0 0
1 5 1
19 3 1
6 14 1
9 1 1
6 10 1
2 15 1
5 6 2
12 6 2
7 3 2
2 14 2
3 1 2
4 4 2
