width 20
height 20
@.....@...@@@.......
@...@...........@...
................@...
.......@.......@..@.
.@............@.....
.....@......@.......
...@..@.............
....................
..@.@.@.@...........
@....@........@..@..
........@...@@..@...
@.........@.........
@..@...@............
@....@..........@...
...........@.@......
@...................
@.......@..@........
@@...@..............
....................
@@...........@......
14
15 18 0
1 16 0
17 13 0
3 2 0
7 19 0
8 15 1
11 11 1
4 6 1
12 7 1
4 15 1
6 16 2
9 15 2
18 9 2
12 11 2

19 3 0
2 17 0
3 14 0
9 10 0
19 0 0
17 0 1
14 18 1
19 19 1
4 13 1
9 1 1
10 10 2
19 13 2
11 10 2
13 4 2
