width 20
height 20
..........@@@..@@..@
......@.............
....................
.......@.@.....@....
.@..........@.....@.
......@......@..@...
..@.................
.....@....@...@.....
@...................
@.@.................
@......@..@..@......
@..@.@........@.....
....@...@..@........
.................@..
@......@............
.............@......
........@.......@...
@........@.....@....
..................@@
.......@@.......@@@@
14
6 18 0
6 19 0
8 6 0
17 8 0
15 1 0
15 7 1
1 16 1
5 19 1
17 0 1
19 16 1
10 8 2
16 4 2
15 4 2
12 17 2

3 7 0
12 13 0
19 17 0
16 14 0
2 0 0
9 4 1
6 11 1
19 16 1
12 2 1
14 12 1
0 18 2
13 6 2
11 15 2
12 17 2
