width 20
height 20
@@@@@@@.@.@@@@.@.@@@
@@@@@......@.......@
@@@@@@@.@.@.@.@@.@..
@@@@@.@@......@.@@.@
@.@@...@.@.@@.....@@
.....@@.@.@...@.@@.@
.@.@........@@@.....
@@..@.@.@.@.@.@@.@@.
@.@..@...@@@....@.@.
....@@@.@.@.@.@.@...
.@.@..@........@@@@.
..@..@..@.@.@@@.@.@.
.@@.@.@.@@@@........
@@@.@.....@.@@.@@.@@
@@....@@.@......@@@@
...@.@@@@.@.@@.@@@@@
.@@@....@...@@@@@@@@
.@@@@.@.@.@.@@@@@@@@
.@@@@@..@@..@@@@@@@@
.@@@@@@...@.@@@@@@@@
17
1 8 0
7 19 0
5 7 0
18 2 0
3 8 0
5 4 0
18 3 1
8 1 1
10 4 1
6 16 1
0 5 1
9 0 1
13 8 2
16 4 2
1 11 2
19 2 2
15 12 2

1 9 0
4 14 0
17 12 0
15 12 0
17 9 0
8 13 0
14 0 1
7 1 1
5 7 1
11 6 1
2 9 1
0 16 1
14 10 2
11 18 2
11 14 2
3 13 2
7 17 2
