width 20
height 20
@@@@@@@..@@@@@@@@@@@
@@@@@@.@.@@@@@@@@@@@
@@.@.@.....@@.@@@@@@
.......@.@..@.@.@@@@
@@@@@@@@@@@........@
@.@..@...@.@.@.@.@..
....@@@@.....@.@@..@
.@.@@@@@@@.@@@..@@@@
..@@@@@......@.@@@@@
.@@@.@@@.@.@.@....@@
..@....@..@.@@@.@@@@
.@.@.@@..@.....@@@@@
.......@..@.@.@@@@@@
.@.@@.@..@...@@@@@@@
@@@@..@.@.@.@@@@@@@@
@@@@@.......@@@@@@@@
@@@@@@.@@.@..@@@@@@@
@@@@@@@@@@@.@.@@@@@@
@@@@@@@@.......@@@@@
@@@@@@@@@.@.@.@@@@@@
17
12 4 0
11 3 0
4 3 0
11 17 0
9 2 0
7 0 0
1 10 1
9 10 1
9 14 1
14 18 1
2 7 1
9 6 1
18 6 2
16 4 2
6 15 2
12 6 2
8 9 2

9 14 0
12 16 0
6 10 0
1 8 0
5 14 0
5 3 0
4 3 1
3 6 1
17 9 1
2 11 1
13 3 1
12 4 1
11 6 2
0 3 2
8 15 2
16 4 2
9 8 2
