width 20
height 20
.@.@@.@@.@.@@@@@@@@@
....@.@.....@@@@@@@@
.@@.....@.@..@@@@@@@
...@@@@@@@.@..@@@@@@
@.@.@.@@@@...@@@@@@@
@.......@@.@.@@.@@@@
@@.@@.@@...@@.@..@@@
@@@...@..@....@.@@@@
@@@.@..@.@@.@...@@@@
.@.@.@.@@@@@..@...@@
........@@@@.@..@...
.@.@.@@@@@@@@.@@..@@
.@@@....@@@@@.@@@.@@
..@@.@.@@@@.......@.
.@.@@...@@@@.@.@.@..
.@..@@.@@@@..@@....@
..@......@@@..@@.@@@
.@@@.@.@@@@@@@@@@@@@
.@...@.@@@@@@@@@@@@@
@@.@.@@@@@@@@@@@@@@@
17
7 16 0
16 13 0
5 2 0
19 14 0
5 5 0
5 6 0
13 7 1
16 15 1
3 4 1
7 14 1
6 15 1
1 10 1
17 13 2
15 8 2
9 1 2
12 5 2
0 12 2

13 16 0
15 6 0
17 11 0
19 10 0
6 5 0
0 16 0
3 5 1
6 18 1
5 5 1
0 13 1
15 10 1
3 16 1
6 10 2
7 1 2
15 13 2
0 15 2
1 3 2
