width 20
height 20
......@.@..@.@@.@.@@
.@@@@.....@@.......@
..@@..@.@...@.@.@.@@
.@...@@@..@@@@@@...@
@@@.@@@@.@..@.@.@.@@
@@..@@@@@..@@...@..@
@@@..@.@.@....@...@@
@@@@.......@@.@@@@@@
@@@@@@.@@.@...@@@@@@
@@@@@@@@@@@@@..@@@@@
@@@@@@@@@@@@@.@@@@@@
.@@@@@@@@@@@...@@@@@
..@@@@@@@.@.@.@@@@@@
.@@@@@.@.......@@@@@
..@@@..@@@.@.@@@@@@@
@.@@@@.@.@..@@@@@@@@
..@@@......@@@@@@@@@
@.@@@@.@@@@.@@@@@@@@
..@@@@.@....@@@@@@@@
@........@.@@@@@@@@@
17
14 1 0
0 3 0
17 5 0
4 7 0
8 19 0
6 6 0
6 19 1
5 1 1
7 0 1
13 12 1
3 4 1
17 2 1
8 4 2
7 16 2
13 7 2
11 12 2
0 1 2

0 14 0
4 6 0
13 5 0
1 16 0
10 7 0
6 13 0
14 11 1
12 11 1
8 6 1
12 1 1
1 14 1
8 13 1
9 8 2
12 6 2
6 16 2
8 16 2
1 15 2
