width 20
height 20
......@........@@@@@
....................
.@..@...............
......@.............
.............@...@@.
........@.......@..@
.....@.@..@.........
....................
@@@.....@.....@.....
@@@.@.......@.......
@@.........@......@.
@@............@.....
@@.........@........
@.@.................
....................
..@.@.@.@..@...@....
..........@.........
..................@.
.......@..@..@.@....
..@.................
4
6 4 0
5 13 0
16 17 1
2 7 2

19 1 0
12 8 0
17 17 1
15 4 2
