width 20
height 20
...@@...............
................@.@.
........@....@......
......@.....@.......
.@..@...............
........@.@....@....
....................
.@..@.......@.@.....
......@.@.@.....@...
.@...........@......
..............@.....
...@......@.........
....@.@....@.@..@...
@....@............@.
....@..........@....
......@.............
....@......@........
........@.......@...
.@..@......@....@...
....................
15
2 1 0
8 13 0
13 0 0
0 3 0
0 19 0
7 2 1
9 9 1
10 15 1
1 11 1
10 16 1
18 19 2
9 15 2
7 16 2
10 2 2
14 0 2

19 9 0
17 5 0
9 16 0
13 5 0
18 6 0
6 6 1
17 17 1
11 13 1
0 10 1
16 13 1
0 1 2
18 0 2
7 16 2
9 0 2
3 1 2
