width 20
height 20
@@@@................
@@@@....@...@.......
@@@...........@.....
......@...........@.
...........@....@...
.@...@......@.......
.......@...@.......@
..................@@
@..............@....
@..@................
.........@..@.......
...........@.......@
@.....@...@..@...@..
....................
.@........@.........
....................
...........@........
...@......@.........
@@@@......@....@....
@@@@..@.............
15
6 5 0
7 1 0
8 13 0
2 12 0
11 2 0
13 17 1
9 12 1
13 13 1
7 7 1
3 4 1
3 10 2
13 11 2
14 7 2
2 10 2
18 8 2

6 7 0
13 0 0
3 8 0
2 9 0
11 18 0
9 7 1
18 0 1
10 1 1
8 18 1
1 16 1
19 0 2
9 17 2
3 10 2
5 3 2
13 16 2
