width 20
height 20
.....@..............
..@...............@.
.....@....@.........
.............@...@..
...@................
.............@......
.....@..............
....@...@.......@...
..@......@..........
.....@........@.....
.........@..........
@.................@@
@.................@@
.....@............@@
..................@@
...................@
........@.@..@.....@
...@...@.........@@@
....@...............
@@........@@.@......
16
10 12 0
8 3 0
10 6 0
12 4 0
18 10 0
12 9 0
17 15 0
8 8 0
0 17 0
10 13 0
6 18 0
0 10 0
2 7 0
8 14 0
15 11 0
15 1 0

4 3 0
11 4 0
17 1 0
7 14 0
2 17 0
0 8 0
19 1 0
18 18 0
8 18 0
18 0 0
19 0 0
15 0 0
7 12 0
9 14 0
0 7 0
19 10 0
