width 20
height 20
...@................
....................
....@......@......@.
....@...........@...
......@......@......
.......@.@..........
........@@@.........
.....@..@....@......
...@....@...........
.....@......@...@...
..@............@....
......@.@...........
.....@.....@.@......
.@...............@..
@........@...@......
.....@....@...@..@.@
.....@..@..@........
@@............@.....
@@@.@...............
@@@@.........@......
16
15 1 0
17 2 0
14 8 0
10 7 0
13 5 0
18 1 0
9 19 0
14 1 0
4 7 0
3 18 0
5 19 0
0 9 0
14 4 0
12 4 0
6 3 0
16 18 0

9 16 0
17 5 0
5 3 0
9 13 0
13 6 0
6 16 0
5 1 0
7 10 0
18 18 0
16 6 0
3 13 0
0 9 0
0 15 0
16 5 0
1 8 0
6 8 0
