width 100
height 100
@@@@.............................................@.............................@.........@@.........
@@@@..............@.....................@............@........@@....................@...@@....@.....
......@.........@.....@.@..@........................@..........@.@...@.@.@........@......@....@.....
...@..........@.................@........@..................@.............@..................@......
......@.............@.....@......@..@.@.@........@......@....................@....@.@.....@........@
...........@..................@......@.......@.....@......@..@......@.........@..........@.........@
.@............@.@..@..@...................@.................@.@.@........@..........@.@............@
.......@..@.......@.......@......................@.@...............@..@......@..@...................
........@...@......@.....@..............@.....@.........@..@......@.......@...@..........@.......@..
..@..........@..@..@..........@........@...@.........................@.....@...@..@.......@.@..@....
....@.........................@...@.@.....................@.......@..@....@@........................
..@......@.....@.....@..@...............@.@........@..@......@.@.@.......@@.............@...........
@............@.....@..@........@...@..............@.@...................@......................@....
..................@.............................@...............................@...@..@...@........
...@......@......................@.........@...........@......@..@....@........@.................@..
..@.@.........@.......@.....@.@......@.......@......@...............@...............................
.............................@................@..............@.@............@.......@...@....@......
...........@..............@..............@..........@..@...@.......@..@......@....@..@..............
@@.............@.........@....@..@.....@........................@.........@.........@.@.............
@@@..@.@.................@....................@......@...@.......@........................@.@.......
@.........@.@.........@...@......................@.........................@...@.............@......
.............................@.@..@.......@........@..............@..@...........@.................@
..................@..............@..@...@.........@........@@@.......................@..........@..@
...@..@..@..@...@...........@..........@........@................@............@.@.......@......@....
.....@........@...................@..........@.@.....@................@...@.......@.......@.........
......@............@.....@.....@.@..@.......@.....@.............@............................@......
.@..........@.......@.......@...@...............@..@....@.@................@..@.@...................
................@.....@.@...........@.........@......................@....@.......@......@.....@....
...........@..............@.....@.........................@....@................@............@.@....
..@......@...@.....@......................@...........@..............................@...........@..
......@...@..@....@..............@.....@.@....@....@..................@..@..........................
.............@...@....@.....@.@..............@..@.@...@@.......................@.......@..@.........
.@..................................@.........................@............@.@......@...............
.........@...@......@...@........@...@.......@.@.@.................@.........................@..@...
...........@....................@.........@............@..........................@.@...@......@....
.@........@.@............@.@......@..@.............@.........@........@.....@..@.....@......@.......
..@............@.....................................@.@....@....@...@.....@........................
.............@.......................@..@.................@...........@.................@...........
...@@..@..@....@....@@......@...@...........@.@.@..............@...@.@.........@..............@.....
..@.....................@..@................................................@........@...@........@.
......................@..........@................@......@...........@...@.@........................
.............@...@.....@.......@...............@....@.........................@....@.........@..@...
....@....@...................................@..@..............@..........@.............@...........
@@................@....@.....@.....@...........@............@..........@..........@.............@...
@@..........@.....@...@.....@...........................@..@..............@.@....@...@..............
....@..........@............@...@....@............................@...........@.....@...............
.........@.@.....................@@..........@....@.@.....@.....@.................@.@...........@..@
...@...@......@....@.@....@.@........@....@.@.@........@...@...........@.@..................@......@
....@...................@.....@.......@..............@............@.................................
.............@..@...............@.@.........@..........@..............................@.....@.......
......................@.....@..@.........@......@............@.........@.......@.@.......@.....@....
.......@.@....................@.....@.@...........@....@................@........................@..
.....@...............@.@................@.........................@.......@......@..................
...........@.@..........@......................................@.@............@........@...@..@.....
.......@......@..........@.@..@...........................@...........@........@....@.....@..@..@...
...@....@.@.......@..@...............@..........@...@............@......@.@.@.......................
......@.....@...............@......@..@.....@.........@........@......................@...@.@.......
@..@.....@........@..........................@.@..@...............................@..@..@.......@...
.....................@................................@.........@....@........................@.....
....@.......@.......@........@...@.@........@.@...............@..@.@............@...................
.........@..............@......@........@.........@....@....@....@.....@............................
......@........@......@...............@....................@....................@....@....@.........
.....@.................@.@..................@..@......@..........@...@........@.@@@@................
...@.............................@.......@.......@..@...........................@@@@................
..........@...@..............@..........@.@..@........@@.......@...........@.....@@@....@.....@.@..@
..@.....@...@...@.@.........@.......@..................@..............@.@........@@@..@..@...@......
.@.....@.@.........@..@...........@..@...........@................@...........@...................@.
.......................@..@............@.@...@...@@....................@.........................@..
..@.....@..@...@..@...@@.....@...........................@@@....@....@.......@.@............@.@@....
........................@.......@.............@.....@....@@@@..@....@...............@....@..........
..................@..@....@...@...@..@..@@.@.@.............@............@......................@....
....@.@.......@.@............@...........@.....................@...@.........@..................@...
@..........@...........@.@..........@.......@..@....@....@..........@..........@...@..........@..@..
@..@....@...@......@...............................................@...@..............@.............
.........@..................@...........@......@.................@...............@.............@....
................@..........@.......@......@..............@....@................@.......@.@........@.
.@............................@..@.............@..@.......@..@..........................@.....@.....
.....@...@....@..........@.@.@.........@....@....@.....@.............@........@...@.................
.@................@.@..@.........@........@...@............@...@.@...................@.........@@...
..@........@....@...............@..@.....@.............@.@....................@.@..@...@.@.....@..@.
.......@.....................@..................@.@.@.....@..........@.......................@......
...........@.............@..........@.......@..........@........@.....@....................@........
...@..@.@........@........@............@.............................@........................@.....
...............@........@......@..................@.......@..@........@..@.......@.@................
....@...............................@.@...@....@..................@.........@........@........@.....
..........@.............@..@...............@........@.....@....@.....@...........@..........@..@....
.....@...@......@...@..........@.@.........................@.................@......@....@..........
.......@....................@.....@....@.........@..@.@..............@..@...@..@....................
@@..@...............@.....................................@......@..@........@....@.....@..@..@.@...
.................@......@.........@..........@...@...................................@..............
.@.....@........@.....................@.........@.....@..........................@.@..@....@..@.....
...........@....................@......@.............@......@.....@.....@....@.........@.......@....
....@.@..@........@.....@........@.@......@...............................@.........................
............@....@............@...........@.@....................@..@......@.................@......
.@......@............@.....@...........@.............@........@........@...........@@...............
.......@@...........@..........@.........@......@.....@..@..@....@........@....@....@@..............
..@..@...................@...........@.@............................@............@..................
@@@.............@..@........@................@.......@........@.......@....@............@.....@.@...
@@@................@@...........@......@............................@@@.............@...............
@@@.........@@@@....@...............................................@@@.............@....@@.........
16
43 37 0
78 40 0
96 44 0
12 37 0
87 76 0
51 90 0
35 16 0
65 94 0
63 24 0
72 85 0
42 41 0
51 71 0
34 45 0
75 89 0
57 3 0
24 43 0

97 93 0
18 9 0
96 14 0
82 99 0
15 24 0
92 2 0
85 1 0
97 18 0
56 66 0
76 78 0
51 27 0
5 35 0
83 91 0
40 32 0
1 89 0
20 43 0
