width 20
height 20
@@@@@@@@@@@@@@@@@@@@
@@@@@@@@@@@@@@@@@@@@
@@@@@@@@@@@@@@@@@@@@
@@@.@@@@@@@@@@@@@@@@
@@...@@@@@@@@@@@@@@@
@@.@@.@@@@@@@@@@@@@@
@@....@@@@@@@@@@@@@@
@@.@@.@@@@@@@@@@@@@@
@..@.@@@@@@@@@@@@@@@
@@...@.@@@@@@@@@@@@@
@@@@.@.@@@@@@@@@@@@@
@.......@.@.@@@@.@.@
@@@@.@@.....@......@
@@@..@..@.@.@.@.@@@@
@@..@@@..@.....@@@@@
@@@.@@..@@@@.@.@@@@@
@@@@@@.@.@.@@.@.@@@@
@@@...............@@
@@@@.@.@.@.@.@.@.@@@
@@@@..@@@...@@@@@@@@
21
9 11 0
7 11 0
3 6 0
4 10 0
11 14 0
5 6 0
8 18 0
6 15 0
5 19 0
14 14 0
7 13 0
14 15 0
2 8 0
4 17 0
11 12 0
4 19 0
12 17 0
9 13 0
8 14 0
3 15 0
4 12 0

11 12 0
10 14 0
17 12 0
7 13 0
16 12 0
17 17 0
3 17 0
3 9 0
4 10 0
13 12 0
18 11 0
4 4 0
11 19 0
1 8 0
6 11 0
9 11 0
8 18 0
12 18 0
15 13 0
15 12 0
14 12 0
