width 20
height 20
...............@.@@@
..@....@.@...@.@..@@
....................
..@......@..........
....@...............
........@...@.@.....
.@..................
..........@.........
......@@...@..@.....
....@...............
.....@@.......@.....
..................@.
.......@....@.......
....@.@...@....@.@..
....................
..@.................
.......@.....@......
....@...@.....@.....
...............@....
....................
14
0 5 0
3 4 0
19 8 0
10 5 0
17 14 0
19 5 1
1 7 1
6 12 1
7 6 1
1 4 1
12 7 2
14 7 2
5 3 2
10 9 2

1 5 0
2 6 0
16 14 0
15 19 0
18 14 0
2 17 1
7 15 1
11 7 1
6 16 1
1 4 1
11 5 2
14 6 2
8 12 2
1 19 2
