width 20
height 20
....................
....@...............
....................
...@.@..............
........@.....@.....
.......@..@.........
...@................
.....@.......@..@...
.......@............
...........@........
....@.@........@..@.
.......@............
.@............@.....
..........@.........
.....@.........@....
..@.....@........@..
....................
......@.@...@....@..
@...........@.......
...........@@..@....
11
0 10 0
4 11 0
2 19 0
1 14 0
2 17 1
1 8 1
16 8 1
9 8 1
14 0 2
6 8 2
15 4 2

18 0 0
19 1 0
10 17 0
17 18 0
2 17 1
7 9 1
13 16 1
8 1 1
9 12 2
19 18 2
5 1 2
