width 20
height 20
@...................
........@........@..
......@.......@.....
....@......@........
@@.....@....@@......
............@@@.....
....................
....................
..@.@....@...@.....@
....................
.................@..
..@.@...@......@..@.
........@@..........
..@.@...@...@.@.....
....................
.........@..........
....@.@.............
.............@@@....
.............@@@....
.............@@@@...
7
18 10 0
6 10 0
18 1 0
16 10 0
15 2 0
0 9 0
19 15 0

16 10 0
19 19 0
14 15 0
2 0 0
16 9 0
1 0 0
10 18 0
