width 90
height 90
..........@...........@@@@@@@.............................................................
........@..............@..@@@.....@...@.@.....@...............................@......@...@
.......@......@.......@.......@....@.............................@........................
..@.......@..@...@.............@.....@.@....@.....@.......@........@..@.@........@........
...@.@..........@@...............@...........@...................@...................@.@..
@......@.@.................@......@@.......@.....@......@...@..@..@.......................
..........@....@.@...@....@.@.....@@.@.@........@.@..@.....@..........@...@.....@.........
......................@.........@.@................@...........@...........@........@.....
.......@....@.....@........@.....@...............@...................@....@...............
...@..@..@............@................@.............@.....@....@.....@...................
..............@......@..............@...@...@....@...@........@......@..........@.@..@....
...@.....@.@....@..........@......................@....@...........@.......@..@...........
....................@.............@.@...@..........@.................@....................
......@.....@.........................@.............@..........@.@......@...........@.....
....@..........@.@..@.....@....@..@.@..@.......@@...@....@....@............@.@..@.@..@...@
......@..@..............@..................@....................@.......@................@
........@.@..@.......@.........@.................@...........................@...........@
.................@.@.....@.......@.......@.....@..............@.@....@....@....@.....@@...
............@.............@.@..........@......@.........@...@.........................@...
....@.@..@.@...@..@...........@..................@................@.......@..............@
........@...@...........@...........@........@..@@...................@..........@...@..@..
......@........@..........@........................@...........@..........@...@...........
..@..........@...@.....@....@..........@................@.@..@....@...............@.....@.
....@.....................@.@@........@..@.....@....@...............................@.....
..................@..........@@.@...@......@..@@..@..@...............@....................
..@......@...................@....@.......................@....@...@...@.@.@...........@..
.@..@.@..............@....................@...@.....@.@...................................
..........@......@..............@...@.@.........@...............@.....@.@........@........
..................@..@.........@.......@.@......@..@...@.@......................@..@......
..@........@..@.....@.@...@................@................@...@...........@.........@...
.............@................@.....@..................................................@..
..@...@..@.............@.........@.......@....@...@.....@......@...................@.@....
................@.........................@.........@.......@....@...........@............
...@....................@...@.@...@.@.....@...@..............@.....@..............@.......
.................@.@.....@.....@..........@......@.............................@.......@..
.........@...@................@...@...@.........@.........................................
...@.........................@.......@.@...@............@.@...@....@..........@......@....
.............@......@.........@........@......@.@..@..@.....@...@.......@...........@@..@@
..@...@...@........@..............................@..@...@...........@...@..........@@....
..............@.@......@..@......@....@.....................@.............@..@..@.....@...
..........@........@.....@.@....@...@..........................@...................@......
.......@................@..@................@..............@........@@.@....@.@..@@..@....
..................@...................@..............@..........................@.....@...
.....................@.@.....@.@..................@@.........@.....@.......@..............
....@......@..........@...........@......@.....@.@........@...@......@..............@.....
..................@.................@.............@................................@......
......@@.@....@..@......@....@......@..............@.@............................@....@..
......@@.....@....@....@.......@........@.....@.@................@.....@...........@......
....@....................................@.....@..............@.@..............@..........
................@.......@.................................@....@......@...................
.............@...@.......@.......@...................@..@.........@......@.@..@...........
.....@.@..@.@..............@...............@...............@..@....@.......@..............
....@............@.@.@.............@........@......@.@.@................@....@.........@..
..............@............@............@.......@.@@..................@...@.........@.....
...@.........@....@.......@@.......@...@..........@@......@........@...............@...@..
....@............@@..@.@..@@......................@....@.@.............@.........@........
........@.......@@.........@@.@....@.@....@....................@.........@...@............
...@.......@..@..@......@..@@....@..@.............@.......@...............................
.........@.................@@..........@@..............@...@..@...........@.@....@..@.....
....@........@.@................................@.@......@........@....@......@...........
.....@.........................@..@...........@.....................@.....@....@........@.
....@.....@@......@.........@.......@......@....@........@.......................@....@...
..........@...............@............@.........@........@.....@..@..........@@...@......
.......@.............@...........@...@..@..............@..........@....@.@................
....@.....@.................................@...........@..........@.................@..@.
@...............@.....@........@.....@....@........@.......@....@.........................
...........@.......................@...@..........@.........@....@........................
..@...................@.................@...@..........@.................@...........@....
.......@.....................@........@...@.......@.........@....@........................
.....@...........@............@.....@...................@...................@..@..........
..........@..@.....@...@...............@...............................@.....@..........@@
..............@..@.@..@....@....@..@.@...@.....@............@..@.@.......@.....@........@@
............................@.........@..........@.@......@.........................@.....
..@....@.@.....@......@.............@...............@.@........@.......@..................
................................@.@........@...@.....@...........@.........@............@.
................@...........@......@..@....................@...@...@.....@..@.......@.....
.....@..@..............@......@..@.................@....................@.........@...@...
.@.@..@...........@.............@...........@...................@...@.....................
...........@..@.............@..........@.........@............@..............@............
............@......@.....@.....@........@....@.....@@....@........@.....@........@...@....
........................@..........@......@..@@..@.@@......@.@.....@.......@..............
..............................@.........@.......@.....................@...................
.....@.@........@.....@..........@.................................@....@...@.....@.......
.........@.@..............@..@......@......................@.........@...................@
....@..............@...................................@...@@.@....@......@........@......
....................@..@...........@..@...@....@...........@@..............@..............
.@.......@....@.@..........@............@.....@.@......@...............@.......@......@.@.
...........@......@.@....@....@.............@..................................@@.........
@.........................................................................@@..@@@.........
@.......@..........................................@@.....@...............@@..@@@.........
12
62 39 0
71 0 0
44 0 0
21 22 0
0 13 1
76 77 1
11 28 1
87 66 1
41 2 2
22 68 2
28 12 2
18 70 2

4 63 0
0 86 0
5 40 0
64 25 0
8 75 1
2 5 1
1 87 1
80 70 1
0 42 2
15 42 2
12 73 2
86 24 2
