width 20
height 20
.@@.@@@...@@@@@@.@.@
....@@@@.@.@@@@.....
@@@..@@....@@@..@@@.
@...@@@@@@..@..@.@..
@@.@.@@.@.@..@...@@.
...@......@.@..@.@..
.@...@@.@.....@...@.
..@.@@@..@@@@@@@.@.@
@..@@@@@@...........
..@@@@@@@@.@@.@.@.@.
@..@@.@@@..@.@@@.@@.
@@.....@.@.@.....@..
@..@@.@.....@@.@.@.@
.@@@@@@@.@.@@@@....@
.@@@@@..@@..@@@@.@@.
..@@@@.@@@.@@@@@....
.@.@@.......@@@@.@@.
......@@.@.@@@@@@.@.
@@@.@.@..@.@@@.@....
@@@@@@@@..@@@....@@.
13
1 12 0
6 5 0
9 6 0
9 8 0
18 5 0
17 1 0
16 11 0
16 6 0
3 0 0
16 0 0
14 12 0
9 16 0
3 11 0

6 11 0
11 6 0
4 6 0
1 8 0
7 14 0
11 4 0
15 8 0
8 7 0
4 2 0
2 12 0
19 3 0
5 5 0
12 6 0
