width 20
height 20
@...@.....@@..@@@@@@
@.@@.@@.@.@..@.@@@@@
.......@...@.....@@@
@.@.@@...@...@.@..@@
@..@@@@.@@.@@..@@@@@
..@.@@@@...@.@.@@@@@
@......@@.@@.@.@@@@@
@.@.@.@.......@@@@@@
@..@@..@@@.@.@.@@@@@
..@@@.@.@@@@...@@@@@
@.@.........@.@@@@@@
@@.@@.@.@.@@@@@@@@@@
@....@@@..@@@..@@@@@
@.@@.@@@@.....@@@@@@
...@....@.@.@@@@@@@@
@.@@.@@....@@@@@@@@@
@@.....@.@@@@@@@@@@@
..@.@.@@@@@@@@@@@@@@
@...@@@@@@@@@@@@@@@@
@@@@@@@@@@@@@@@@@@@@
9
7 14 0
1 5 0
1 14 0
2 12 0
5 14 0
14 4 0
5 10 0
13 2 0
1 4 0

14 5 0
7 11 0
5 11 0
5 0 0
9 2 0
4 12 0
7 0 0
2 14 0
4 1 0
