width 20
height 20
....@...@.......@@@@
................@@.@
@..........@........
....@....@...@......
........@...@.@.....
........@...........
...@.....@..........
....................
...@...@........@...
...........@......@.
..@.................
......@..@..........
..@........@.@...@..
....@............@..
......@....@...@...@
..............@.....
.....@..@......@....
.......@..........@.
..@...........@@@@@@
.........@....@@@@@@
5
11 13 0
0 17 0
0 13 1
7 9 1
3 14 2

1 15 0
14 17 0
17 7 1
8 19 1
11 18 2
