width 20
height 20
....................
....................
.............@......
.....@....@...@.....
...............@....
.............@......
..@....@......@.....
....@....@..........
.............@......
........@.........@@
..........@.@.......
.@@@..@........@....
.@@@........@.......
................@...
....@........@@.....
..@@.@..............
...@....@...........
...........@.......@
.....@..............
....................
5
14 12 0
6 9 0
15 3 1
17 6 1
0 4 2

9 5 0
19 19 0
7 15 1
11 5 1
5 8 2
