width 20
height 20
@@@.@@@@.@.@....@..@
@@...@@.....@.@..@..
@..@@@..@.@....@@..@
@.@@.@@..@.@.@@..@.@
...@..@@@@....@.@@.@
@@.@.@.@.@.@@...@@.@
@..........@@@.@@...
@.@@@.@@@.@@@@.@@@.@
...@@@@@.@@...@@@...
@.@@@.......@..@.@.@
..@@.@@.@.@.@@.@....
@.....@@.@.@.@.@.@.@
@.@@.@...........@..
.@.@...@.@.@.@.@@..@
.@..@.@.@@@.@....@..
...@@@..@.@.@.@@..@.
.@....@.@.@..@@@.@..
..@.@.@...@.@.@..@@.
.@@@....@......@@...
@@@@@.@@@.@.@@....@.
4
5 17 0
5 4 0
2 15 0
6 9 0

1 15 0
12 8 0
11 4 0
1 10 0
