width 20
height 20
@@@@@@@@@@@@@@@@@@@@
@@@@@@@@@@@@@@@@@@@@
@@@.@.@@@@@@@@@@@@@@
@@....@@@.@@@@@@@@@@
@.@@@..@...@@@@..@@@
@..@..@@@.@@@@.@.@@@
@.@..@@@.....@...@@.
....@@@.@@.@@@.@....
@.@@.@..@.......@.@.
@......@@@.@@.@.@@..
@@@@@@.@@...@@...@.@
@@@....@@@@.@@@.@@@@
@@@@.@@@.....@@@@@@@
@@@@...@@.@.@.@@@@@@
@@@@@.@.@.@@..@@@@@@
..@@.........@@@@@@@
@....@@@@.@.@@@@@@@@
@@.@....@@@@@@@@@@@@
@..@.@@..@@@@@@@@@@@
@@.@@@@.@@@@@@@@@@@@
4
1 15 0
6 17 0
9 14 0
13 8 0

5 3 0
18 10 0
9 14 0
7 18 0
