width 20
height 20
.@.@.@@@@@@@@@@....@
......@@@@@@@@..@.@@
.@.@.@.@@@@.@.@..@@@
@@.@....@@@.....@@@@
@@@@@@.@.@.@.@.@.@@@
@@@@@.......@....@@@
@@@@.@.@.@.@@@@@..@@
@.@@.@..@...@@@@.@@@
.......@@@@.@.......
.@@.@.@.@.@...@@.@.@
...@@@....@@.@@@@...
@@@@@@@.@....@@@@@.@
@@@@@@...@@@@.@@@@.@
@@@@@@@.@@@....@@@..
@@@@@@@@@@@@@.@.@.@.
@@@@@@@@@@@@........
@@@@@@@@@@@@@.@.@@@.
@@@@@@@@@@@@@@@.@@@@
@@@@@@@@@@@@@@@@@@@@
@@@@@@@@@@@@@@@@@@@@
13
4 0 0
9 5 0
16 9 0
18 15 0
3 9 0
8 4 1
13 13 1
14 5 1
11 9 1
14 15 2
9 11 2
7 9 2
6 10 2

7 9 0
9 5 0
14 13 0
10 11 0
15 3 0
4 1 1
18 8 1
7 10 1
15 17 1
13 13 2
17 8 2
16 15 2
9 10 2
