width 20
height 20
@.@.@.@@@@.@@@@@@@@@
@......@.....@@@@@@@
@.@.@.@.@@.@.@@@@@@@
..@@........@@@@@@@@
@..@@@@.@.@@@@@@@.@@
@.@@@@@@..@@@@@@..@@
...@..@@@@.@.@.@.@@@
@@...@.@.........@.@
...@.....@.@@.@.@...
.@..@.@.@@..@..@@.@.
..@@@@..@@.@@.@...@.
.@@.@.@..@.@@@@@.@@.
.@......@@.......@..
@..@.@.@@@@.@@@.@@@.
@@.@@@..@@@@@@@@....
...@@@.@@@@@@@@@@.@.
.@..@.@.@@@@@@@@@..@
..@...@..@@@@@@@@.@@
.@@@.@@.@@@@@@@@@@@@
...@....@@@@@@@@@@@@
13
13 8 0
7 10 0
3 2 0
13 10 0
19 11 0
5 9 1
10 12 1
0 10 1
1 0 1
6 12 2
6 3 2
11 1 2
1 4 2

9 5 0
1 0 0
6 19 0
17 17 0
1 1 0
17 10 1
14 7 1
19 13 1
18 16 1
6 10 2
8 3 2
12 12 2
14 12 2
