width 20
height 20
@@@@@@@@@@@@@@@@@@@@
@@@@@@@@@@@@@@@@@@@@
@@@@@@@@@@@@@@@@@@@@
@@@@@@@@@@@@@@@@@@@@
@@@@@@@@@@@@@@@@@@@@
@@@@@@@@@@@@@@@@@@@@
@@@@@@@@@@@@@@@@@..@
@@@@@@@@@@@@@@@@@@..
@@@@@@@@@@@@@@@@@..@
@@@@@@@@@@@@@@@@@@..
@@@@@@@@@@@@@@@@@.@.
@.@@@.@@@@@@@@@@....
...@@.@@@@@@@@@.@.@.
@.@....@@@.@.@@....@
@.@@@.@..@......@@@@
..@@@.@.@.@.@@.@@@@@
@..@@.@.....@..@@@@@
.@......@.@@@@.@@@@@
.@.@@.@@@.@@@@.@@@@@
...@@@@@@@@@@..@@@@@
13
17 12 0
5 12 0
2 17 0
2 18 0
14 15 0
12 13 1
0 15 1
0 12 1
16 13 1
8 14 2
7 14 2
1 14 2
2 16 2

1 13 0
12 14 0
11 15 0
3 17 0
2 16 0
19 11 1
19 12 1
17 11 1
17 13 1
19 9 2
6 17 2
18 6 2
2 18 2
