width 20
height 20
@...................
...................@
.@................@@
.....@..@..@..@....@
........@...........
...@....@.....@....@
........@@......@..@
.@..................
.@.@..............@.
.....@..............
........@....@..@...
.....@.....@...@.@..
....................
..............@.....
@@........@.........
@@..............@...
@@....@.............
@@..................
...............@....
..................@.
15
14 0 0
10 17 0
6 1 0
2 19 0
5 13 0
3 16 0
12 5 0
2 6 0
18 6 0
14 8 0
9 2 0
17 12 0
12 2 0
9 5 0
14 17 0

0 18 0
9 13 0
16 13 0
3 15 0
5 13 0
12 2 0
8 11 0
2 13 0
2 9 0
0 19 0
12 1 0
4 19 0
2 4 0
7 15 0
12 6 0
