width 20
height 20
.................@@@
................@...
............@.......
.....@..............
@@..........@......@
@.@@.....@.......@..
....................
...........@........
..@.....@....@..@.@@
......@...........@@
...@.........@.....@
....@.@...........@.
....................
.@.............@....
.....@@......@......
.@..@.@...........@.
.......@....@..@.@..
........@..@........
@........@.....@....
....................
11
2 11 0
12 8 0
16 18 0
7 7 0
9 2 1
11 19 1
15 9 1
7 5 1
7 12 2
5 18 2
8 16 2

16 4 0
0 19 0
4 3 0
7 6 0
18 19 1
11 6 1
2 15 1
19 19 1
2 3 2
4 2 2
18 1 2
