width 20
height 20
@.....@@...@@@@@@@@@
@.@..........@@@@.@@
@@...........@@...@@
@@..............@.@@
@.................@@
.......@......@...@@
..................@@
..@..........@....@.
........@...........
.@.......@......@...
..@......@@.........
...........@....@.@.
....................
.....@..............
........@...........
.......@........@..@
..@..@.....@........
.@.............@....
...........@........
..@.................
1
17 7 0

15 5 0
