width 20
height 20
.@@@@@......@@......
....@........@......
....@.........@.....
...@..@....@........
.................@@.
.........@..@....@@.
...@...........@....
.........@....@.....
.....@.@....@.....@.
...@................
................@..@
......@...@.......@@
...............@..@@
.......@..@.@...@..@
.........@.@...@....
....................
@@@....@......@.....
@@@........@........
@@@.......@...@.....
@@@@.@..............
1
10 7 0

15 19 0
