width 20
height 20
@@@@@@@@@@@@@@@@@@@@
@@@@@@@@@@@@@@@@@@@@
@@@@@.@@@@@@@@@@@@@@
@@@....@@@@@@@@@@@@@
@...@@..@@@@@@@@@@@@
.@.@..@..@@@@@@@@@@@
.....@@.@@..@@@@@@@@
.@@.@...@..@.@@@@@@@
.@..@.@@@@....@@@@@@
.@@.@@..@.@@@..@@@@@
.@@@@@@.......@@@@@@
..@.....@.@@@.@@@@@@
@...@@.@....@@.@@@@@
..@.@...@.@.....@@@@
@..@@@.@.@@.@.@....@
..@@@@@....@@.@.@.@@
@.....@@@@....@@..@@
..@.@@@@@.@@.@@@@@@@
.@....@@.....@@@@@@@
.@.@.@@@@@.@.@@@@@@@
13
3 9 0
4 3 0
4 16 0
5 3 0
1 15 0
2 12 1
9 18 1
2 8 1
4 11 1
11 18 2
6 13 2
7 11 2
4 19 2

0 6 0
1 11 0
6 12 0
11 13 0
1 14 0
5 8 1
17 16 1
15 15 1
6 9 1
5 11 2
2 16 2
7 6 2
4 11 2
