width 20
height 20
.......@@@..@@@@@.@@
.@.@@.@@.@@.@@@...@@
..@..........@.@@..@
.@@@.@.@.@.@...@@@..
.@@@@.@@..@@.@..@..@
@........@..@..@@.@@
@@.@@@.@.@.@.@.....@
.@.@@@@..@.....@.@..
...@@...@@@.@@.@@@.@
.@@.@.@..@@@.@..@...
....@@..@.@...@.@@.@
@.@..@.@....@..@@@@.
@@..@.@.@.@.@@@@.@..
@.@......@...@@..@.@
....@@@.@@@.@..@....
@.@.@....@...@...@.@
...@.@.@@.@.@@.@@.@@
@.@@.........@.....@
....@@.@@.@.@.@@@.@.
@.@@@@...@..........
4
10 15 0
11 5 0
1 8 1
11 7 2

0 0 0
14 17 0
0 4 1
1 19 2
