width 20
height 20
@@@@@.@@.@@......@@@
@@@.......@.@@.@..@@
.@@@.@.@@..@@@.@@..@
.@@@..@@..@.@.@...@.
..@@@@..@.....@.@...
.@.@.@@...@.@..@@.@.
......@.@..@..@.@..@
.@@@.@@@.@.@@.....@@
..@@@.@..@@@@.@.@.@@
.@.@....@.@@@@@@@.@@
...@.@@....@@@@@@..@
@@...@@@@.@@@@@@..@@
...@@.@.@..@.@@@@...
.@@.@.....@@..@@@.@.
@.@...@.@.@..@@@.@..
@...@@.@@@.@..@...@.
@@@.@........@.@@...
@.@...@.@@.@......@.
....@..@@@@@@.@.@..@
@.@..@.@@@@@...@@@..
4
8 8 0
1 19 0
7 14 1
8 16 2

16 14 0
9 1 0
0 12 1
12 15 2
