width 20
height 20
@@@@@@@@@@.@..@@@@@@
@@@@@@@@@....@.@@@@@
@@@@@@@@@@.@....@@@.
@@@@@.@@@@..@@.@.@..
@@@@....@.@@......@.
@@@..@.@.....@.@@...
@@@@..@..@.@.@@.@.@@
.@.@.@.@..@..@......
.........@@@..@.@@@.
@@.@.@.@..@@.@.....@
....@.@..@.@.@.@@.@.
.@.@..@.@...@.@.@...
..@..@.@.@@.......@.
.@@@......@.@.@.@@@@
..@@@.@@.@@@...@@@@@
.@.@.@.@.@@@@.@@@@@@
.........@@@..@@@@@@
.@.@.@.@@@@@@@@@@@@@
.@..@....@@@@@@@@@@@
..@.@@@.@@@@@@@@@@@@
4
14 2 0
16 12 0
7 18 1
2 7 2

8 5 0
6 5 0
2 16 1
19 3 2
