width 20
height 20
@@@@@@@@@@@@@@@@@@@@
@@@@@@@@@@@@@@@@@@@@
@@@@@@@@@@@@@@@@@@@@
@@@@@@@@@@@@@@@@@@@@
@@@@@@@@@@@@@@@@.@@@
@@@@@@@@@@@@..@...@@
@@@@@@@@@@...@..@@@@
@@@@@@@@@.@.@.@..@@@
@@@@@@@@....@.@.@@@@
@@@@@@@@.@@......@@@
@@@@@@@...@@.@@.@@@@
@@@@@@@@.@..@@....@@
@@@@@@@@.@@.@.@@@@.@
@@@@@@@@..@....@....
@@@@@@@@.@..@.@@@.@.
@@@@@@@@...@@@@@@@..
@@@@@@@@@.@.@.@@@.@.
@@@@@@@@............
@@@@@@@@@.@@@@@.@.@.
@@@@@@@@...@@@@@..@.
12
9 18 0
11 9 0
11 17 0
11 8 0
8 17 0
12 6 0
17 19 0
11 6 0
8 8 0
18 17 0
14 13 0
10 15 0

8 15 0
9 17 0
18 17 0
16 9 0
13 13 0
17 5 0
10 11 0
10 15 0
15 17 0
15 18 0
17 18 0
15 5 0
