width 20
height 20
@......@.@.@@@.@..@@
@@@.@.@........@.@.@
@@@@@...@.@.@.@.....
@@@...@@@@@@..@@@@.@
@...@..@@@@@.@@@@...
@.@.@.@@@@@...@@.@@.
..@@@@@@@@.@.@@.....
@..@@@@@........@@.@
..@@@@@@@@@.@.@..@..
.@@@@@@@....@@..@.@.
@@@@@....@.@..@...@@
@@@@@@@@..@.@...@.@.
@@@@@@@..@@...@@....
@@@@@@@@.@@@@.@@@.@.
@@@@@@@@@@@@@@@@...@
@@@@@@@@@@@@.@@@.@.@
@@@@@@@@@@@@.@.@..@@
@@@@@@@@@@@@.....@.@
@@@@@@@@@@@@@@.@...@
@@@@@@@@@@@@@@@@@.@@
1
4 0 0

17 14 0
