width 20
height 20
@@@@@.@@@@@@@@@@@@@@
@@@@...@@@@@@@@@@@@@
@@@@@.@..@@@@@@@@.@@
@.@@...@.@@@@@@@@..@
.....@.@.@@.@..@.@..
.@.@@..@.....@.@...@
@@@@@@...@.@.@.@.@.@
@@@@@@@@..@.......@@
@@@@@@@..@@@.@@.@.@@
@@@@@@@@.@@@@@.@@.@@
@@@@@@@...@@@..@....
@@@@@@@@.@@...@.@@.@
@@@@@@@@@...@.......
@@@@@@@@@.@.@@.@.@@@
@@@@@@@@@@@@...@.@@@
@@@@@@@@@@@..@.@...@
@@@@@@@@@@@@..@@.@..
@@@@@@@@@@@@.@@@@..@
@@@@@@@@@@.....@.@..
@@@@@@@@@@.@@@@....@
1
12 11 0

2 4 0
