width 20
height 20
@@@@@..@@@..@@@@@@@@
@@@@@.@....@.@@@@@@@
@@@@....@@.....@....
@@@@@@@...@@.@..@@.@
@@@@@@..@.@..@@@....
@@@@@@.@@@@@..@.@@.@
@@@@..@.@.@.@.@....@
..@.@...@.......@.@@
.@....@...@.@.@..@@@
...@.@.@.@@@@@..@@.@
.@@@@......@@@@.....
..@...@@@.@@@@..@.@.
.@.@.@@@@@@@@.@.@@..
...@@.@@..@.@.@...@.
@@..@..@@.@...@@.@@@
@@@.@.@.@...@.@@@@@@
.@........@..@.@@@@@
...@@.@.@..@@...@@@@
.@@@@@@@@@.@.@.@@@.@
.@@@@@@@@@..........
1
10 17 0

9 17 0
