width 20
height 20
@......@.@@.@@.@.@@@
@@.@.@....@.......@@
@@..@@@.@...@@.@.@@.
@@@@@@.@.@.@@@@.....
.............@@@@.@@
.@.@.@.@@@.@..@...@@
..@@@@@@@@@@@..@@@@@
@@@@@@@@@@.@..@.@@@@
@@@@@@@@@...@...@@@@
@@@@@@@@@@@...@@@@@@
@@@@@@@@@@@.@..@@@@@
@@@@@@@@@@@@@@@@@@@@
@@@@@@@@@@@@@@@@@@@@
@@@@@@@@@@@@@@@@@@@@
@@@@@@@@@@@@@@@@@@@@
@@@@@@@@@@@@@@@@@@@@
@@@@@@@@@@@@@@@@@@@@
@@@@@@@@@@@@@@@@@@@@
@@@@@@@@@@@@@@@@@@@@
@@@@@@@@@@@@@@@@@@@@
1
15 5 0

14 6 0
