width 20
height 20
@............@......
...................@
@.....@.@...........
@...@........@......
.......@.......@....
......@.............
....................
...........@........
.....@....@...@.@...
....................
....................
........@@@.........
................@...
...@.....@...@...@..
.@@.@...@...........
.@@.................
............@.@@....
..@...@.........@...
..........@.....@.@@
................@@@@
15
15 11 0
5 14 0
8 17 0
17 4 0
5 2 0
17 17 1
14 10 1
5 12 1
12 10 1
7 8 1
3 3 2
10 6 2
7 6 2
14 18 2
5 13 2

14 17 0
9 14 0
4 17 0
2 11 0
5 3 0
2 8 1
1 0 1
1 13 1
15 3 1
18 16 1
10 16 2
18 17 2
0 19 2
12 9 2
11 16 2
