width 20
height 20
.........@......@@@@
..@.@.@....@....@@@@
.................@@@
@.........@@.....@@.
..@.@.....@.........
....................
........@@..........
........@@...@..@...
.@..@....@....@.....
....................
............@.......
....................
....@..@...........@
..@..........@.....@
@.....@.@......@....
@.........@.........
........@@@@@.......
@@....@.@@@@........
@@.....@@@@@........
@@....@@@@@@@..@....
6
13 19 0
0 2 0
16 9 0
14 1 0
12 6 0
2 9 0

2 10 0
17 16 0
7 17 0
6 7 0
2 19 0
13 6 0
