width 20
height 20
.....@@..........@@@
....................
...............@....
.......@............
....................
.@.......@..@.....@.
..@.......@..@.@....
.@.................@
...................@
.@.......@...@......
...........@........
...................@
@.........@...@...@@
@..@..............@@
@.@.....@..@...@...@
..............@.....
....................
..........@......@..
@@..................
@@@................@
6
18 18 0
19 3 0
15 18 0
14 17 0
4 12 0
19 1 0

16 13 0
13 14 0
13 3 0
14 19 0
10 19 0
12 9 0
