width 20
height 20
@@@...@@@@@.........
@@@..@@@@@......@...
.@@..........@......
....@.......@.......
...@.......@.@......
........@.......@...
.....@.@...@..@.....
.................@..
.@.......@..........
....................
....................
......@....@..@.....
..........@.........
......@..@..........
....@...............
..............@.....
.@....@...@.@.......
.................@@@
@..@...........@@@@@
@@.............@@@@@
6
7 19 0
5 10 0
10 7 0
10 14 0
2 4 0
5 0 0

13 17 0
11 18 0
15 3 0
9 3 0
19 16 0
0 6 0
