width 20
height 20
@.................@@
@.......@..........@
.......@............
......@.......@.....
....................
@...@@..@.......@...
@...................
@..........@...@.@..
.@.@..@.............
...........@.@...@..
......@...@.........
.....@..............
.............@......
...............@....
......@@............
.@@........@.@...@..
.@@.............@...
@@@@..............@@
@@@...............@@
@@@........@......@@
14
17 4 0
7 9 0
9 0 0
2 3 0
18 12 0
2 1 0
15 12 0
13 14 0
15 3 0
11 5 0
18 2 0
12 14 0
2 12 0
19 14 0

6 2 0
14 1 0
3 11 0
2 3 0
17 13 0
12 16 0
6 1 0
10 12 0
15 10 0
1 3 0
12 1 0
3 0 0
8 15 0
19 15 0
