width 20
height 20
..............@...@@
.........@........@@
........@..........@
.......@....@...@..@
@...................
@...................
...@...@...@...@....
....................
....@...@....@......
............@.......
.......@..@.........
...@..........@....@
....................
.....@...@.........@
....................
.............@......
...@...@............
.....@..............
................@.@.
......@@@...........
14
17 12 0
18 11 0
13 14 0
17 11 0
7 0 0
16 7 0
3 9 0
13 18 0
3 15 0
7 2 0
5 9 0
14 10 0
16 17 0
6 2 0

2 2 0
17 11 0
8 3 0
10 7 0
15 10 0
19 12 0
19 18 0
0 0 0
11 2 0
12 13 0
19 17 0
7 0 0
1 2 0
18 19 0
