width 20
height 20
.......@.......@@@@.
.................@..
..@........@........
@....@......@.......
....................
.....@.@.@.@........
......@.....@.......
.....@........@.@...
........@..@........
@...................
...@.......@..@.....
.........@.......@..
@...................
.............@......
....@...............
@.......@.@....@....
............@.......
....................
.....@....@.@...@...
....................
14
4 3 0
1 5 0
5 8 0
10 5 0
1 8 0
8 17 0
7 18 0
10 11 0
6 18 0
18 9 0
14 12 0
14 3 0
8 19 0
17 4 0

14 14 0
18 7 0
5 13 0
2 15 0
11 1 0
4 18 0
1 0 0
17 7 0
7 7 0
3 11 0
1 11 0
3 16 0
10 17 0
6 14 0
