width 20
height 20
......@@@@.........@
.......@@@..........
..@....@@...@.....@.
..............@.....
...@..@..........@.@
..........@.........
....................
........@...@....@..
....@.........@.@...
....................
@.@.....@..@........
@.............@.....
......@..@.@........
....................
.........@...@...@..
...@....@.....@.....
.......@.......@...@
@..................@
@.................@@
@......@.@........@@
14
7 6 0
14 1 0
2 3 0
6 6 0
5 0 0
5 9 0
7 17 0
7 13 0
16 7 0
16 13 0
3 12 0
16 10 0
0 3 0
0 0 0

12 12 0
14 1 0
17 19 0
14 12 0
19 10 0
19 1 0
18 0 0
17 18 0
13 9 0
10 8 0
10 2 0
15 5 0
1 4 0
6 6 0
