width 20
height 20
@@@@@@@@@@..@@@@@@@@
@@@@@@@@@.@..@@@@@@@
@@@@@@@@...@.@@.@@@@
@@@@@@@@.@...@.....@
@@@@@@@@@@.@@@.@@@@@
@@@@@@@@........@@@@
@@@@@@@@@.@.@@.@@@@@
@@@@@..@.@.@@..@@@@@
@@@.@@.....@..@@@@@@
@@@....@.@...@...@@@
@@@@@.@..@@@@.@.@.@@
@@.@@.@@.@@.@.......
@@.@.@........@.@.@@
.......@@.@.@..@....
@.@@.@.@@@@@@.@@@.@.
....@@..@.@@@@@@@.@.
@@@.@.@....@@@@@@@@.
@@@@....@.@.@@@@@@@@
@@@@@@.@......@@@@@@
@@@@@@.@@.@.@@@@@@@@
10
6 12 0
12 3 0
13 7 0
3 9 0
8 16 0
3 13 0
12 1 0
15 10 0
18 11 0
14 4 0

10 7 0
8 8 0
8 16 0
3 9 0
9 12 0
14 6 0
2 13 0
13 12 0
17 10 0
10 3 0
