width 20
height 20
@@@@@@@@@@@@@@@@@@@@
@@@@@@@@@@@@@@@@@@@@
@@@@@@@@@@@@@@@@@@@@
@@@.@.@@.@@.@@@@@@@@
@@@....@..@..@@@@@.@
.@..@.@..@@@...@@...
..@..@..@.@@.@@.@@.@
@..@..@.............
@.@.@...@.@@.@@.@.@.
......@.@@@@...@@@..
.@.@@..@@@@@@.@@@.@.
.@@@@.@@@@@@@.@@....
.@.@...@@@@@@@@..@.@
....@.@@@@@@@@@@.@@@
@@@@@@@@@@@@@.@...@@
@@@@@@@@@@@@@..@.@@@
@@.@.@@@@@@@@.@@.@@@
@.......@@@@......@@
@@@.@.@@.@@.@.@.@..@
@@@@...........@@.@@
10
3 9 0
12 6 0
5 3 0
10 7 0
1 7 0
3 13 0
3 3 0
5 17 0
16 7 0
3 18 0

7 17 0
14 19 0
4 6 0
15 12 0
0 12 0
14 17 0
1 17 0
10 7 0
13 14 0
8 19 0
