width 20
height 20
@@....@@@@@@....@.@@
@..@.@@@@@...@.@...@
@@.@.@@@@@@@.@..@.@@
.@..@@@@@@@@.@.@....
...@@@@@@.....@@@@.@
.@..@@@@@@.@@.......
@..@.@.@.@..@@@.@.@@
.@.@.......@@@@@@@@@
.@...@.@.@..@@@@@@@.
...@.@@.@.@@@@@@@@..
@@.@..........@.@.@.
@@.@.@.@.@.@@.....@.
@@@.@@@.@@@...@.@...
@@@.@@..@...@..@..@.
@@@....@.@.@@@@@.@..
@@@@.@.@...@@@@@@.@.
@@@.@....@.@@@@@....
@@@..@.@.@.@@@@@@.@.
@@@@....@@@@@@@@@@..
@@@..@.@@@@@@@@@@@@.
10
2 9 0
19 17 0
6 7 0
16 14 0
2 11 0
19 16 0
5 18 0
10 6 0
11 4 0
3 17 0

9 9 0
8 14 0
4 14 0
0 4 0
8 17 0
1 9 0
12 1 0
4 0 0
10 11 0
5 10 0
