width 20
height 20
@@.@.....@@@@.@@@@@@
@@..@@@.@.@@.....@@@
@..@.@.......@.@..@@
@@...@@.@@.@.@@..@@@
@..@.....@@@@.@@.@@@
@@..@@.@@.....@....@
@@.@@@....@.@.@@.@.@
@@@...@.@.@..@@@..@@
@@@@.@@..@..@.@..@.@
@@.@.@.@@@@.@..@....
.........@.@.@...@@.
@.@.@@.@.......@.@@@
@..@..@@.@.@.@.@..@@
@.@@@.@@@@@..@..@...
....@.@@@@@@@@.@..@.
@.@.@.@@@@@@@@@@@@@.
@@@.....@@@@@@@.....
@@@.@@.@.@@@@@@.@.@.
@@@@.@.........@@..@
@@@@...@.@.@.@@@@.@@
1
6 9 0

15 17 0
