width 20
height 20
@@@@@@@@@@@@@.@@@...
@@@@@@@@@@@@@.@@.@.@
@@@@@@@@@@@@@..@....
@@@@@@@@@.@@..@..@.@
@@@@@@@.....@.@.@@..
@@@@@@.@@.@@....@@@.
@@@@.......@@.@@.@..
@@@@@@.@.@@......@@.
@@@@@@@....@.@.@.@@.
@@@@@@@@.@....@..@.@
@@@@@@@@@@.@.@@@...@
@@@@@@@@@@@@.@@@.@..
@@@@@@.@@@@@@.@.@..@
@@@@@...@.@@......@@
@@@@@@.@@....@.@@.@@
@@@@@@.@..@.@..@@@@@
@@@@@....@@@@@@@@@@@
@@@@@@.@...@@@@@@@@@
@@@@@...@.@@@@@@@@@@
@@@@@@.@..@@@@@@@@@@
1
14 13 0

8 9 0
