width 20
height 20
@@@@@@@@@@@@@.@..@@@
@@@@@@@@@@@@....@@@@
@@@@@@@@@@@@@.@..@@@
@@@@@@@@@..@@@@@..@@
@@@@@.@@.@.@@@@..@@@
@@@@@.........@.@@@@
@@@@@@@.@.@@@....@@@
@@@@@@@@@@....@.@@@@
@@@@@@@@@.@@.@...@@@
@@@@...@...@@.@.@@@@
@@@.@.@..@........@@
@@......@..@.@@.@..@
..@.@@.@..@@@.@@@.@.
@....@@@@.@@...@....
..@.@@@@@.@..@..@.@.
@..@@@@@@@.@..@@@@..
@.@.@@@@@....@@.@.@.
....@@@@@@.@........
.@@@@@@@@@.@@.@.@@@@
.@@@@@@@@@...@@@@@@@
1
11 7 0

7 11 0
