width 20
height 20
......@....@........
......@........@....
....@@..............
.....@@.......@.....
....................
.........@.....@....
..........@...@.....
..@........@@.......
@................@..
@....@.......@......
..@...............@.
......@..........@..
........@...........
......@.....@.....@.
.@......@...........
.............@..@@@@
....@.....@.@..@@@@@
...............@@@@@
....@..........@@@@@
@..............@@@@@
4
0 0 0
14 4 0
8 4 0
1 8 0

1 0 0
7 12 0
10 19 0
0 10 0
