width 40
height 40
................@......@......@.........
......@....@..............@........@....
.................@.@....................
......@.@............@.......@..........
@............@........@..@.......@......
@......@.@................@.@.@.........
...............................@...@.@@.
............@..@....@..@...@.........@@.
.......@................................
........@.....@..@.@.....@.@........@...
....@..................@...........@....
.....@.@..@...@...........@..@......@.@.
......@.@....@..............@...........
.............................@...@......
..@...........@..@......................
......@.....@.......@...................
........@..........@......@.............
.........@....@...@.......@......@......
....@........@..@..@......@....@........
.....@....@...@..........@@@@...........
..@.......@..........@..@..@@.......@.@.
..........@.........@@.....@....@.@.....
.................@......................
........@............@.@.@....@.........
.....@.......@.............@...@........
............@.....@..@......@.........@.
.........@.@..@........@.........@......
.....@..................@...............
..............@..@....@.........@.@.....
..@.@.@..@.@..................@.........
.............................@...@......
.......@........@.....@.................
.........@..............@...@........@..
.............@.@.@..............@.......
............@.....@.................@.@.
......@..............@..................
........................@..@...@........
..........@............@......@........@
.............@........@....@...........@
...........@.....@@@.................@@@
10
19 12 0
29 16 0
20 8 0
10 25 0
33 5 1
24 0 1
36 26 1
22 32 2
16 21 2
6 21 2

32 0 0
22 0 0
20 24 0
13 39 0
19 14 1
6 34 1
34 18 1
11 20 2
39 29 2
13 11 2
