width 20
height 20
..........@@........
................@...
....@.@.............
.............@@@....
.......@.@...@@.....
....@...............
......@........@....
.........@..........
...........@........
....@.......@.......
...@....@.........@.
....................
..............@.....
..........@.@..@....
...@..@....@..@.....
....................
@@..................
@@..................
@@.....@............
@@@.................
3
10 7 0
8 15 1
2 17 2

19 19 0
18 13 1
18 0 2
