width 20
height 20
@@.@@.@@@@@@..@@@@@@
@@......@.@.@..@@@@@
@..@@@@.......@@@@@@
.@.@@@.@.@.@.@@@@@@@
....@.....@@@@@@@@@@
@@@.@@@.@@@@@@@@@@@@
@@@..@..@@@@@@@@@@@@
@@..@@@.@@@@@@@@@@@@
@@@..@...@@@@@@@@@@@
@@@@..@.@.@.@@@@@@@@
@@@..@@......@@@@@@@
@@@@@@@@@@@@@@@@@@@@
@@@@@@@@@@@@@@@@@@@@
@@@@@@@@@@@@@@@@@@@@
@@@@@@@@@@@@@@@@@@@@
@@@@@@@@@@@@@@@@@@@@
@@@@@@@@@@@@@@@@@@@@
@@@@@@@@@@@@@@@@@@@@
@@@@@@@@@@@@@@@@@@@@
@@@@@@@@@@@@@@@@@@@@
14
6 8 0
12 10 0
1 2 0
2 2 0
13 2 0
6 6 1
8 4 1
8 3 1
8 10 1
9 4 1
12 3 2
9 10 2
2 4 2
7 10 2

0 3 0
7 8 0
3 4 0
2 0 0
2 1 0
1 4 1
3 10 1
14 1 1
11 1 1
13 1 1
6 1 2
9 10 2
8 2 2
7 2 2
