width 20
height 20
@..@..@.@@@@@@@@@@@@
@.@..@...@@.@@@@@@@@
..@@..@.@@...@@@@@@@
@.@.@.....@@..@@@@@@
......@.@...@.@@@@@@
@.@.@..@..@....@@@@@
...@..@@@@@.@.@@@@@@
@.@@@......@...@@@@@
@.@@..@@.@..@@@@@@@@
@..@@@@@@..@@@@@@@@@
..@@@@@@@@@@@@@@@@@@
@..@@@@@@@@@@@@@@@@@
@@..@@@@@@@@@@@@@@@@
@@@..@@@@@@@@@@@@@@@
@@@.@@@@@@@@@@@@@@@@
@@@@@@@@@@@@@@@@@@@@
@@@@@@@@@@@@@@@@@@@@
@@@@@@@@@@@@@@@@@@@@
@@@@@@@@@@@@@@@@@@@@
@@@@@@@@@@@@@@@@@@@@
20
0 2 0
10 2 0
3 14 0
0 4 0
1 5 0
3 5 0
5 6 0
6 7 1
5 4 1
2 12 1
10 8 1
7 2 1
4 13 1
5 7 1
11 5 2
13 5 2
12 7 2
10 7 2
1 8 2
5 0 2

9 9 0
13 5 0
2 11 0
5 0 0
11 8 0
12 2 0
8 7 0
7 7 1
0 10 1
11 5 1
5 7 1
0 4 1
1 7 1
2 0 1
7 3 2
10 9 2
4 13 2
10 7 2
6 7 2
9 5 2
