width 20
height 20
............@.......
.....@@.........@...
.........@.@@.......
...@............@...
....@.@.............
...@........@..@....
......@...........@.
....................
..@...............@.
......@.@...........
...........@........
.....@@.......@.....
....................
.............@......
......@....@........
....@.......@.......
.@.@..@.@...........
............@.......
.........@.@....@.@@
@@..........@.....@@
15
11 17 0
8 4 0
3 14 0
4 11 0
5 4 0
14 3 0
4 7 0
3 11 0
10 16 0
3 18 0
5 13 0
8 18 0
18 10 0
2 15 0
9 4 0

19 14 0
7 2 0
4 5 0
19 12 0
8 5 0
1 15 0
3 6 0
2 11 0
17 1 0
19 1 0
4 17 0
19 0 0
18 10 0
12 3 0
13 17 0
