width 20
height 20
....................
.........@.@........
....................
...@....@......@..@@
...........@......@.
...@................
....................
.....@.@.........@..
........@....@......
..@.@...............
.........@.@........
....@...............
.................@..
......@..@.....@....
.@...........@......
....@...............
...........@.@......
....................
....................
......@@@....@@@@...
10
18 9 0
11 19 0
1 18 0
3 16 0
18 12 0
7 0 0
15 18 0
14 3 0
18 7 0
4 19 0

0 9 0
10 16 0
4 16 0
19 19 0
13 3 0
7 1 0
2 0 0
13 9 0
16 10 0
19 0 0
