width 20
height 20
@@@@@@@@@@@@@@@@@@@@
.@@@@@@@@@@@@@@@@@@@
.@.@.@..@@@@@@@@@@@@
.@....@....@@@@@@@@@
.@.@@...@.@@@@@@@@@@
.@.@..@.@@@@@@@@@@@@
....@.@...@@@@@@@@@@
.@.@@@@.@..@@@@@@@@@
..@.@.@.@.@.@@@@@@@@
.@..@....@@.@@@@@@@@
@@@...@@@.@..@@@@@@@
@@@.@@.@@...@@@@@@@@
@@........@.@@@@@@@@
@@@.@@.@.@..@@@@@@@@
@@..@@.@..@.@.@.@@@@
@..@@@@@.@.......@@@
@@@@@@@@@@@.@@.@....
@@@@@@@@@@@@@@@..@@.
@@@@@@@@@@@@@@@@..@@
@@@@@@@@@@@@@@@@.@@@
6
0 1 0
2 7 0
4 5 0
9 7 0
7 3 0
2 2 0

19 17 0
16 18 0
2 4 0
8 15 0
2 12 0
2 9 0
