width 20
height 20
@@@@@@@@@@@@@@@@@@@@
@@@@@@@@@@@@@@@@@@@@
@@..@@@@@@@@@@@@@@@@
@..@@@@@@@@@@@@@@@@@
..@@@@@@@@@@@@@@@@@@
@.@@...@.@@@@@@@@@@@
....@@...@@@@@@@@@@@
.@@.@..@..@@@@@@@@@@
@.....@..@@@@@@@@@@@
.@.@@@@@...@@@@@@@@@
......@@@.@@@@@@@@@@
@.@@@@@@@@@@@@@@@@@@
@..@@@.@..@.@@@@@@@@
..@.@....@..@@@@@@@@
@.....@@...@.@.@.@@@
@@.@.@@..@........@@
....@@@.@.@.@@.@.@@@
.@.@@@@.@.@.@@@@@@@@
@@@@@@@....@@@.@@@@@
@@@@@@@@.@.......@@@
6
0 16 0
2 3 0
0 13 0
8 14 0
2 10 0
9 12 0

11 12 0
3 10 0
2 15 0
7 16 0
16 14 0
2 8 0
