width 20
height 20
@@@@@......@@.@.@...
@@@@@@.@.@........@.
@@@@@@@@@..@@@.@.@.@
@@@@@@@@@@.@@@.@....
@@@@@@@@@@@@@.@@@@.@
@@@@@@@@@@@@@..@@..@
@@@@@@@@@@@@..@@.@.@
@@@@@@@.@@@@.@@@...@
@@@@@@...@.@.@@.@.@@
@@@@@.@.@..........@
@@.@....@.@.@.@.@@..
@...@.@.@..@.@@..@@@
..@.@..@@@.@.@@.@.@.
.@....@......@......
@.@@@.@.@@.@@.@@.@.@
@.......@...@.....@@
@@.@.@@.@.@@@@.@.@.@
@...@@@.@@@@@@@..@..
@@.@@@....@@@@@@.@.@
@@@@@@@.@....@@.....
6
14 1 0
6 15 0
9 19 0
13 6 0
7 7 0
7 0 0

7 16 0
16 9 0
15 12 0
9 2 0
8 0 0
17 8 0
