width 20
height 20
@.@@@.@@@@@..@@@...@
.......@.@@.@.@@.@@@
@.@.@.@............@
..@@@...@.@@.@.@.@@.
@...@@@..@@...@.....
..@....@@@@@@.@@@@@.
@.@.@.@@@@@@@@@@@@..
@.@.@.@@@@.@@@@@@@@.
@@@@...@....@@@@@@@.
@@@@@@...@@.@@@@@@@@
@@@@.@.@..@@@@@@@@@@
@.....@..@...@@@@@@@
..@.@...@@.@.@@@@@@@
@.@..@@.....@@@@@@@@
@@..@@..@@@@@@@@@@@@
@@@..@@@@@..@@@@@@.@
@..@.@@..@@..@@@@@..
@@....@@...@.@@@.@.@
@@@@@....@....@.....
@@....@.@@@.@...@.@.
10
10 7 0
6 1 0
18 2 0
12 16 0
19 5 0
5 12 0
5 2 0
8 13 0
6 12 0
3 14 0

7 9 0
18 0 0
4 17 0
1 3 0
8 2 0
6 18 0
11 8 0
6 5 0
1 4 0
19 8 0
