width 20
height 20
....@@..............
.................@..
..............@.....
............@.......
..@.......@.........
........@.......@...
............@.......
@......@............
.........@.......@..
.....@..............
....@........@......
@@............@.....
..@....@..@.........
................@...
.....@...........@..
.............@......
..@...@....@........
....................
.......@............
................@...
18
4 7 0
7 5 0
4 17 0
4 19 0
4 3 0
14 3 0
13 13 0
11 0 0
17 17 0
3 2 0
19 14 0
19 9 0
18 7 0
12 11 0
5 15 0
12 13 0
0 19 0
9 4 0

12 4 0
4 2 0
17 9 0
0 12 0
18 13 0
8 15 0
13 13 0
4 17 0
10 2 0
18 12 0
19 16 0
16 8 0
17 0 0
2 2 0
6 5 0
4 1 0
9 16 0
16 18 0
