width 20
height 20
@...................
......@..@.@........
...@........@.......
....................
....................
.@..................
..............@..@..
....@..@............
...@.......@.@....@.
....................
....................
.@..@...............
.........@..........
....................
..@............@...@
.....@....@.........
.......@...@...@....
...@................
....................
....................
18
8 5 0
7 9 0
12 18 0
18 11 0
11 9 0
4 10 0
0 13 0
4 2 0
17 8 0
9 17 0
6 5 0
7 6 0
8 18 0
16 3 0
7 12 0
18 16 0
14 5 0
11 5 0

10 11 0
17 1 0
12 17 0
15 17 0
8 2 0
3 15 0
4 3 0
6 12 0
2 17 0
13 19 0
0 11 0
18 15 0
15 7 0
6 6 0
5 2 0
6 18 0
17 13 0
0 19 0
