width 20
height 20
.....@@@@@..........
......@@@@..........
......@.....@..@....
.................@..
..@..@..........@...
.............@......
............@.@.....
.....@@...@.........
...............@....
..............@...@.
.......@............
....................
......@.............
.....@....@..@......
.@..................
....................
.........@....@.....
@...@....@@.........
.........@.........@
........@@@@@......@
12
12 12 0
18 10 0
0 6 0
1 6 0
14 11 0
7 9 0
15 19 0
1 0 0
19 1 0
15 14 0
10 12 0
2 15 0

11 13 0
1 0 0
18 19 0
3 12 0
18 3 0
0 6 0
12 7 0
6 5 0
3 0 0
18 5 0
3 6 0
14 3 0
