width 20
height 20
..........@........@
....................
.......@....@.......
......@.@.......@...
....................
.........@......@...
.@...........@......
..@...........@.....
....@.............@.
@...................
@....@..@...........
@........@..........
....@@.....@........
........@....@..@...
...@..........@....@
.........@......@...
..@..@............@.
............@..@....
....................
@@..................
10
2 5 0
4 4 0
16 8 0
16 11 0
16 19 1
5 8 1
4 3 1
19 11 2
11 7 2
10 1 2

18 13 0
3 11 0
0 18 0
3 17 0
2 5 1
14 1 1
18 19 1
18 12 2
4 15 2
3 19 2
