width 20
height 20
@@..................
@@.....@............
@@.@................
........@...........
.............@....@.
.......@..@.........
....................
.....@..@@.@.@......
......@.............
.........@..........
..............@.....
...........@........
.........@..........
...@......@..@.@....
............@...@...
...@.....@..........
..............@.....
.....@.....@.@......
..........@.........
@@@.................
4
11 2 0
9 18 0
17 18 1
6 13 2

18 9 0
16 0 0
9 6 1
7 13 2
