width 20
height 20
...@................
....................
....................
..........@.........
.....@.....@.......@
...@.........@......
..............@.....
........@...........
..............@.....
..@......@..........
........@...........
.............@.@....
....................
...@...........@....
................@...
...............@....
.......@.....@..@...
..@.......@.........
...........@........
....................
4
4 16 0
16 15 0
17 16 1
10 9 2

5 6 0
1 2 0
8 0 1
10 8 2
