width 20
height 20
@@@@@@@@@@@@@@@@@@.@
@@@@@@@@@@@@@@@@@@..
@@@@@@@@@@@@@@@@@..@
@.@@@@@@@@@@@@@@.@.@
@.@@@@@@@@.@@@@..@..
@.@@@@@@@...@@@@.@@.
@...@@@@@@.@@@@@..@.
..@.@@..@....@@@.@..
.@.@...@@@@.@.@@...@
.....@..........@@..
.@.@.@@@.@.@.@.@...@
..@....@@...@@@.@.@@
.@.@@.@@.@.@.@....@@
.....@.........@@@.@
.@@@..@.@.@.@.@.@...
...@.@.@...@@@..@.@@
.@@@...@@.@@@@@....@
@@@@@.@.@@.@@@.@@.@@
@@@@@..............@
@@@@@@.@@.@@@@@@.@.@
14
10 9 0
17 18 0
5 14 0
9 7 0
15 9 0
17 11 0
14 17 0
16 7 0
0 14 0
17 2 0
19 7 0
10 11 0
17 8 0
18 3 0

2 13 0
10 10 0
16 7 0
0 10 0
13 8 0
5 11 0
4 16 0
18 16 0
2 15 0
11 9 0
16 16 0
1 7 0
15 16 0
4 14 0
