width 20
height 20
............@......@
@...................
.......@......@.....
....@.....@....@....
..............@.....
.............@...@..
.....@..............
....................
..@....@...@........
.........@@..@...@..
.........@..........
.@...@......@.......
....................
....@.......@.......
@.............@.....
...............@....
....................
........@........@..
.............@......
....@...............
15
6 18 0
17 19 0
3 1 0
0 10 0
0 13 0
13 4 0
11 6 0
13 1 0
18 18 0
15 7 0
14 5 0
8 16 0
8 3 0
9 8 0
0 3 0

18 5 0
10 13 0
6 19 0
12 10 0
1 17 0
11 3 0
17 13 0
13 1 0
8 0 0
1 3 0
16 8 0
6 16 0
1 8 0
6 11 0
19 18 0
