width 20
height 20
@@@@...........@@@@.
@@@@@.@@.@.@@@..@@..
@.@@....@@@.@@@....@
....@.@.@@...@..@.@@
@.@..@....@.@.@..@@@
@.@@@.@.@...@...@@@@
......@..@@@..@@@@@@
.@.@@...@.@.@...@@@@
@..@@.@...@...@@@.@@
@@@...@@.@..@@.@...@
@.@.@..@@.@@.@.@@.@@
...@.@.......@......
.@.@...@.@.@.@.@.@@.
@@...@@..@@@....@...
@..@@@@.@@@@.@.@@.@.
.@..@@@@.@@.@@..@..@
..@..@@@.......@..@.
@...@.@@@@.@.@.@@...
@@@...@@...@@@@@@.@@
@@@.@@@@@.@@@@@@@@@@
4
1 16 0
0 6 0
5 18 0
9 5 0

12 13 0
5 0 0
17 8 0
17 18 0
