width 20
height 20
@@....@@@@@....@@.@@
@..@.@.@.@..@.@.@.@@
@@@......@@.@......@
@@@@.@.@....@@.@@.@@
@@@@..@@@@.@@@@@@.@@
@@@@.@.........@..@@
@@@..@.@.@.@@.@@@..@
@@@@..@@.@@@@.@@@.@.
@@@@.@@..@@@@..@....
@@@@@@@@@@@@@@@@@.@.
@@@@@@@@@@@@@@@@@@@.
@@@@@@@@@@@@@@@@@...
@@@@@@@@@@@@@@@@@.@@
@@@@@@@@@@@@@@@@@@@@
@@@@@@@@@@@@@@@@@@@@
@@@@@@@@@@@@@@@@@@@@
@@@@@@@@@@@@@@@@@@@@
@@@@@@@@@@@@@@@@@@@@
@@@@@@@@@@@@@@@@@@@@
@@@@@@@@@@@@@@@@@@@@
14
19 11 0
8 2 0
17 6 0
11 5 0
17 11 0
6 5 0
8 1 0
10 3 0
4 6 0
15 1 0
7 8 0
13 2 0
14 3 0
10 6 0

13 0 0
17 4 0
10 5 0
6 3 0
8 7 0
6 1 0
17 5 0
19 8 0
4 6 0
17 6 0
17 12 0
17 3 0
5 0 0
19 10 0
