width 20
height 20
@@@@.@.@.@@.@@@...@@
@@@@........@@.@.@.@
@@@@@.@.@.@@.......@
@@@@@..@@....@@.@.@@
@@@@@.@@@@@.@..@...@
@@@@@@..@.@..@...@@@
@@@@.@.@....@@@@@@@@
@@.......@@@@@@@@@@@
@..@.@@@..@@@@@@@@@@
..@..@...@...@.@@@@@
@@..@.@.@@.@...@@@@@
...@......@..@@.@@@@
@@.@.@.@.@@.@.@.@@..
..@...@@@@@......@.@
@..@.@.@@@@@@.@@@@..
..@.....@@@....@.@.@
@...@@.@.@.@@@......
@@.@@@.@.......@.@.@
@@@@.....@@@.@.@@...
@@@@@.@@.@@@@..@@@.@
12
7 18 0
18 13 0
7 7 0
5 19 0
14 19 1
8 9 1
18 15 1
6 3 1
10 16 2
16 15 2
3 9 2
12 17 2

11 17 0
19 12 0
1 9 0
6 3 0
12 3 1
9 5 1
8 8 1
11 3 1
11 6 2
6 12 2
3 16 2
9 3 2
