width 20
height 20
@@@@@@@@.@.@@@@@@@@@
@@@@@@@@...@@@@@@@@@
@@@@@..@.@.@@@@@@@@@
@@@@.@...@.@@@@@@@@@
@@@..@@.@.@@@@@@@@@@
@..@.@.....@@@@@@@@@
@.@....@@.@@@@@@@@@@
@..@.@..@..@.@@@@@@.
..@@..@@.@..........
@.@.@@@@...@.@.@@.@.
.........@@..@...@..
@.@.@.@@.@@@.@.@..@@
@..@..@.@@@@@@@..@@@
..@@@....@@@@@@@.@@@
@..@..@.@.@@@@...@@@
@.@@@..@...@@@.@@@@@
@@....@..@@@@.@@@@@@
@..@@...@@.@@..@@@@@
@@.@@@@.......@@@@@@
@@.@@@@@.@.@.@@@@@@@
8
3 9 0
19 10 0
18 8 0
5 14 1
15 14 1
1 12 1
15 10 2
5 16 2

1 9 0
12 11 0
9 6 0
16 13 1
2 19 1
8 2 1
10 7 2
5 16 2
