width 20
height 20
@@@@@@@@@.@.@@@@@@@.
@@@@@@@@@....@@@@@..
@@@@@@@@@@.@@@@@@@@.
@@@@@.@@@....@@@@@@.
@@@@@..@@@@.@@@@@@..
@@@...@.@.....@@@.@.
@@@@@.....@.@@@@....
@@@@@@.@.@@@@@@.@.@@
@@@@@@@............@
@@@@@@@@.@.@.@.@@.@.
@@@@@@@@@..@@....@..
@@@@@@@@@@.@.@.@..@.
@@@@@@@@@..@.@@@.@..
@@@@@@@@@@.@..@....@
@@@@@@@@@@@..@.@@.@.
@@@@@@@@@@.@.@......
@@@@@@@........@@.@.
@@@@@@@.@@.@@@.@@@..
@@@@@@@@@@@....@@@.@
@@@@@@@@@@@@.@..@...
15
19 6 0
12 19 0
19 11 0
12 15 0
14 11 0
17 14 0
19 10 0
18 19 0
17 8 0
12 3 0
10 8 0
9 5 0
11 18 0
19 16 0
12 18 0

8 8 0
9 0 0
7 8 0
19 5 0
17 13 0
10 2 0
19 1 0
16 15 0
13 16 0
16 13 0
8 16 0
13 13 0
10 5 0
17 15 0
13 5 0
