width 20
height 20
....................
....................
..@.....@...........
@...................
.....@..............
...........@......@@
.@....@.@.........@@
...................@
......@....@..@....@
@...............@...
...........@........
....@.......@.......
...........@....@...
......@.......@.....
..................@.
...@....@...........
...............@....
.......@............
....................
...............@....
2
0 16 0
8 0 0

14 4 0
0 5 0
