width 20
height 20
.............@......
.......@..........@.
.....@......@...@...
....................
....@..@..@..@......
............@...@...
....................
@..........@........
.....@....@.........
..........@..@...@..
....@...@.......@...
....................
...............@....
....................
.........@..........
.......@@.......@...
....@......@...@....
.........@..@.......
...@@...............
@@@@..............@@
2
3 12 0
1 17 0

9 9 0
4 2 0
