width 20
height 20
@@@@@@@@@@@@@@@@@@@@
@@@@@@@@@@@@@@@@@@@@
@@@@@.@@@@@@@@@@@@@@
@@@@@..@@@@@.@@@@@@@
@@@@..@@@....@@@@@@@
@@@@.@.@@@.@..@@@@@@
@@@.....@@@..@@@@@@@
@@@.@@.@.@.@.@.@@@@@
@@@@@...........@@..
@@@...@.@@.@.@@@@@@.
@@@@.@.@....@@@@@@@.
@@@@@@.@@.@.@@@.@.@.
@@@@@...@@...@......
@@@@@@.@.@@.@.@.@@@.
@@@@@@.@.@........@.
@@@@@......@.@.@@@@@
@@@@@@.@.@@@@....@@.
@@@@@@@@.@.@@@.@..@.
@@@@.....@....@@@...
@@@@@.@@...@.@@@@@@@
3
10 5 0
19 16 1
8 19 2

4 6 0
6 3 1
9 4 2
