width 20
height 20
@@@@@@@...@@@@.@@.@@
@@@@@@@@@.@@@@.....@
@@@@@@@....@@@.@.@.@
@.@@.@.@.@@.....@..@
.........@.@.@.@.@.@
@.@@@@.@@...@..@..@@
@@@@@@....@@@@...@@@
@@@@@@@@@.@.@.@@.@@@
@@@..@@@.........@@@
@@.@.@@@@@.@.@.@.@@@
......@@@@.@@@@@@@@@
@.@.@..@...@@@.@.@@@
...@@@@.@.@@@....@@@
@.@.@.@....@@@@@.@@@
..@.@...@.@@@@@@..@@
@.....@.@.@@@@@@.@@@
..@.@..@..@.@@@...@@
@..@..@@@....@..@@@@
@@@@@.@@@@@.@.@...@@
@@.....@@@@.....@.@@
3
12 17 0
11 3 1
17 1 2

3 13 0
15 12 1
17 14 2
