width 20
height 20
@.@..@@...........@.
@...@..@.@.@@.@.@.@.
..@...@..@@@@@@@@...
@@..@@.@@.@@.@@.@.@@
...@.@.@@.......@.@@
.@........@.@.@....@
..@.@.@@.@...@..@@.@
@..@.@@..@@@@@@@@@@@
.@.@....@@@@@@@@@@@@
...@.@.@@@@@@@@@@@@@
.@..@@@@@@@@@@@@@@@@
@..@@@@@@@@@@@@@@@@@
.@.@@@@@.@@@@@@@@@@@
...@.....@@@@@@@@@@@
@.@..@.@.@@@@@@@@@@@
@...@..@..@@@@@@@@@@
..@.@@.@.@@@@@@@@@@@
@.@..@..@.@@@@@@@@@@
@@..@@@...@@@@@@@@@@
@@@..@..@@@@@@@@@@@@
3
8 12 0
0 16 1
18 6 2

12 0 0
8 13 1
4 19 2
