width 20
height 20
@@@@@@@@@@@@@@@@@@@@
@@@@@@@@@@@@@@@@@@@@
@@@@@@@@@@@@@@@@@@@@
@@@@@@@@@@@@@@@@@@@@
@@@@@@@@@@@@@@@@@@@@
@@@@@@@@@@@@@@@@@@@@
@@@@@@@@@@@@@@@@@@@@
@@@@@@@@@@@@@@@@@@@@
@@@@@@@@@@@@@@@@@@@@
@@@@@@@@@@@@@@@@@@@@
@@@@@@@@@.@@@@@@@@@@
@@@@@@@....@@@@.@@@@
@@@@@...@.@@@@...@@.
@@@..@.@@......@....
@@@@...@@@@.@@@..@.@
@@@@.@..@@.@@@..@@@@
@@@@@@@....@.@@....@
@@@@@@@.@@...@..@.@@
@@@@@@@@@.@.@@@..@@@
@@@@@@@.....@@@.@@@@
15
9 10 0
6 14 0
7 16 0
9 19 0
9 13 0
17 13 0
9 16 0
19 13 0
16 16 0
5 12 0
15 16 0
6 15 0
9 11 0
8 16 0
15 18 0

15 18 0
10 17 0
7 16 0
12 17 0
9 19 0
19 12 0
15 19 0
16 12 0
15 14 0
6 15 0
10 19 0
7 15 0
9 16 0
15 11 0
14 12 0
