width 20
height 20
@@@@@@@@@@@@@.@@@@@@
@@@@....@@@@...@@@@@
@.@.@.@@@@@@.@@@@@@@
........@@@@.@.@@@@@
@.@@.@.@.@@......@@@
@@.@.@...@@@.@.@..@@
@@..@.@@.@@...@..@..
...@.......@@..@...@
@@...@@@@@....@@.@..
@.@@....@@@@@.@@@.@.
@.@.@.@..@@@@@.@....
..@....@.@@@@@.@@@@.
@...@.@@@@@@@...@...
@@@.@.@@@@@@..@@.@.@
@@@@@..@@@@@@.......
@@@@@@..@@@@..@@@@.@
@@@@@@@..@@@@..@@@@@
@.@@@.@.@@@@@@@@@@@@
.........@@@@@@@@@@@
@.@.@.@.@@@@@@@@@@@@
15
12 15 0
19 9 0
14 14 0
14 16 0
12 5 0
1 9 0
5 13 0
1 18 0
5 9 0
17 7 0
13 8 0
18 14 0
13 4 0
7 7 0
14 3 0

8 16 0
12 15 0
5 1 0
6 4 0
12 5 0
0 7 0
14 10 0
8 6 0
18 13 0
19 10 0
16 4 0
18 7 0
16 8 0
17 12 0
1 18 0
