width 20
height 20
@@@@@@@@@@@@.@...@..
.@@@@@@@@@@@...@.@.@
..@@@@@.@@.@.@@@....
.@@@@@@..@.@..@..@.@
..@@@...@....@@@..@@
.@.@.@.@@@@@.@@..@@.
.............@.@.@..
.@.@@.@.@.@.@@.....@
.@@@@..@..@...@@.@@@
..@@@.@@.@..@@@@@@@@
.@.@...@@@@.@@@@@@@@
....@.@@@@..@@@@@@@@
.@@@..@.@.@.@@@@@@@@
@@@@.@@......@@@@@@@
@@@@@@@@.@@.@@@@@@@@
@@@@@@@@@.....@@@@@@
@@@@@@@@@.@.@@@@@@@@
@@@@@@@@@@@@@@@@@@@@
@@@@@@@@@@@@@@@@@@@@
@@@@@@@@@@@@@@@@@@@@
4
2 10 0
15 5 0
16 4 0
19 6 0

11 14 0
13 15 0
12 3 0
6 5 0
