width 20
height 20
@@@@@..@@@@@@@@@@@@@
@@@@.@.@@@.@.@@.@...
.......@@.......@.@@
@.@@@.@.@@@.@.@.....
..@@@....@..@@.@@@.@
@.@@@.@.@.@.@@..@..@
...@.@@......@.@@@..
@.@@....@@@@@@.@@@.@
@@@@@@.@@@@@@@.@.@..
@@.@...@@@@@@......@
.@...@@.@@.@.@.@.@..
..@.@@.......@..@@@@
.@@..@@@.@.@..@@@@@@
....@.....@..@@@@@@@
.@.@@.@@@@.@.@@@@@@@
@....@.@@.....@@@@@@
@@.@......@.@..@@@@@
@@@..@.@.@@@@@@@@@@@
@@@@.@@.@@@@@@@@@@@@
@@@@.....@@@@@@@@@@@
4
0 2 0
4 6 0
18 9 0
5 4 0

1 4 0
1 11 0
5 16 0
9 11 0
