width 20
height 20
@@....@.@.@@.@.@.@@@
@@@.@.............@@
@@@@.@.@@.@@.@.@.@@@
@@@@...@@@.@@...@@@@
@@@@.@.....@@.@.@@@@
@@@@@..@.@@...@...@@
@@@@.@.@@..@.@.@.@@@
@@...@@@@@......@.@.
@@@@.@..@@@.@.@.@.@.
......@.@@.@@@....@.
.@@.@.......@@@.@...
.@@@@@.@@@.@@@@..@@.
@@@@@@.@....@@@@@@@.
@@@@@@@@@.@@..@@....
@@@@@@@@@...@.@.@.@.
@@@@@@@@..@.@.....@.
@@@@@@@@@@@...@@@.@.
@@@@@@@@@@..@.@.@@..
@@@@@@@@@.@.@.....@@
@@@@@@@@....@.@.@@@@
4
13 4 0
13 16 0
9 2 0
3 0 0

4 0 0
5 0 0
0 10 0
16 9 0
