width 20
height 20
@@@..@@@@@@..@@@@..@
....@@@@@@@.@@@@@@.@
@@@..@@@.@..@@.@....
@...@@@....@.....@@.
.@@.@@..@.@@@.@@..@@
......@.@@.@.@@..@@@
@@.@.@.........@.@@@
@..@.@@.@@@.@.@...@@
@.@.@.@@@..@....@@.@
..........@@.@@.....
@@@.@@@.@.....@.@.@@
..@....@.@@@.@@@@@@@
@...@.@..@.....@..@@
@@.@....@@.@.@..@..@
@@@@.@.@@@..@@.@..@@
@@@@@...@..@.@@@.@@@
@@@@@@.@@@........@@
@@@@@@@@@..@.@.@.@@@
@@@@@@@@@@@.@@@@...@
@@@@@@@@@@.......@..
4
10 13 0
17 4 0
19 9 0
13 3 0

0 1 0
3 11 0
12 6 0
14 12 0
