width 20
height 20
.@@.@@..@@@@@.......
.......@@.@@@@.@.@.@
@.@.@.@@...@.@.@.@..
@..@@@@.@.@..@..@@@.
.@.........@...@@@@.
...@.@.@.@.@.@.@@@@@
.@..@...@.....@@@@@@
..@..@.@..@.@.@@@@@@
@@@@.@@.@.@..@@@@@@@
@@@@@......@@@@@@@@@
@@@@@@@.@.@.@@@@@@@@
@@@@@@@.@...@@@@@@@@
@@@@@@@@..@..@@@@@@@
@@@@@@@@@@..@@@@@@@@
@@@@@@@@@@@@@@@@@@@@
@@@@@@@@@@@@@@@@@@@@
@@@@@@@@@@@@@@@@@@@@
@@@@@@@@@@@@@@@@@@@@
@@@@@@@@@@@@@@@@@@@@
@@@@@@@@@@@@@@@@@@@@
3
5 4 0
12 8 1
1 2 2

16 2 0
2 5 1
11 3 2
