width 20
height 20
...@................
...............@....
.....@...@...@......
...@................
....@..@.........@..
..........@....@....
@................@..
........@...........
.......@...@........
..@...........@.....
.......@..@......@..
...........@........
....@..........@....
...@......@...@.....
......@.............
.....@......@....@..
@......@........@...
................@...
...@................
....................
6
6 9 0
6 19 0
11 0 1
4 2 1
18 14 2
5 17 2

18 11 0
10 11 0
15 8 1
4 2 1
14 15 2
7 1 2
