width 20
height 20
@@@@@@@@@@@.@@@@....
@@@@@@@@@@...@..@.@@
@.@@@@@@@.@@..@....@
@..@@@@@....@...@.@@
@.@.@@@@@@.@..@@..@@
.....@@.....@.@@@@@.
@.@@..@.@.@....@....
@@@..@.@.@.@.@...@@.
@@@@..........@.@@@@
@@@@.@.@@.@@.@@@@@@@
@@@@@@@@@@@@@@@@@@@@
@@@@@@@@@@@@@@@@@@@@
@@@@@@@@@@@@@@@@@@@@
@@@@@@@@@@@@@@@@@@@@
@@@@@@@@@@@@@@@@@@@@
@@@@@@@@@@@@@@@@@@@@
@@@@@@@@@@@@@@@@@@@@
@@@@@@@@@@@@@@@@@@@@
@@@@@@@@@@@@@@@@@@@@
@@@@@@@@@@@@@@@@@@@@
1
8 8 0

10 4 0
