width 20
height 20
@...................
@...................
@....@..............
@..........@........
@.....@.@...........
@...................
..........@.........
.......@......@.....
.....@....@...@.....
...................@
..............@.....
.@......@........@..
.....@.......@......
..@............@@...
.......@...........@
...@................
@@....@.............
@@...........@......
...........@........
...........@@.......
3
3 2 0
9 9 0
1 4 0

12 4 0
7 11 0
18 14 0
