width 40
height 40
..@.....................................
.......................................@
.............@..........................
......@.@................@..@...........
...........@.@....@........@............
............@....@...@..@.......@.@.....
......@.............@.@......@..........
.@.......@.@..@...@.....@...@........@..
.................@......................
...@........@@............@.............
..........@@.........@.......@.....@....
.....@.................@................
..........................@.............
....@.@.........@........@.@.....@......
.....@......@..@.....@..................
...............................@.@..@...
.@.....@....@.@...@......@..@...........
........@.@...................@...@...@.
...@..............@....@.@.........@....
..........@.............................
.........@@.........@.......@........@..
..........@...@....................@....
......@.@.......@.........@.............
.@...........@......@.......@.......@...
.......@..........@.....................
.@............@............@.....@......
.......@...@.@..................@.@..@..
......@...........@..@..................
...................@...............@.@..
....@.@......@..........@........@..@...
.........@..............................
@.@........@.....@......................
....@..@.................@......@.@.....
.........@.........@...@...@.@..........
................@.......................
...@...@............@.....@.......@.@...
........................@............@..
............@@....@.........@.@..@..@...
........................................
.........@...........@@@................
29
11 18 0
3 3 0
3 15 0
15 7 0
26 16 0
32 25 0
23 3 0
9 10 0
26 8 0
29 20 0
29 0 1
20 10 1
19 17 1
36 30 1
38 1 1
35 27 1
25 9 1
8 28 1
39 4 1
34 33 1
12 1 2
24 12 2
9 19 2
30 16 2
8 31 2
35 38 2
35 14 2
20 14 2
5 0 2

16 19 0
38 39 0
11 24 0
6 12 0
1 4 0
32 11 0
16 3 0
35 35 0
0 13 0
27 29 0
29 35 1
22 9 1
21 22 1
27 28 1
2 27 1
21 19 1
39 37 1
39 0 1
36 9 1
39 31 1
20 10 2
21 34 2
35 39 2
27 18 2
23 0 2
11 36 2
1 39 2
20 19 2
30 28 2
