width 40
height 40
..@.........@@..............@...........
........@................@..............
......@....................@...@........
..............@.@....@...........@......
..........................@..@..........
......@....@.@.......@..........@.......
.....@.@...........@..@...@....@........
@............@..............@......@....
...........@.....@..........@.@....@....
......@............@..@..............@..
.............@...........@..............
.....@........@.@..@...@.....@.@.@......
@........@............@......@..........
...@.........@................@.......@.
.@...............................@.@....
...@...@......@......@...@..@...........
.....@...@..............@........@.....@
...........@@......@.......@...........@
..@.............@..............@.....@.@
...@.........@.....@.@@...........@.....
...........@.............@........@.@...
..@......@....@.........................
....@...............@.@..@...@.@........
...................................@..@.
..........@.....@....@..........@.......
.@...@.....@............................
...............@@@.@....@............@..
@.@........@..............@.............
..........@........@....................
........@.............@.......@.........
.....@.@...........@.....@......@.......
..........@.@...@.......................
..@..@......@....................@......
......@.@.@.@.....@.@......@............
..............@..@........@.............
..@...................@.................
.......@..........@..@.@................
..@...@.....@...............@...@.@.....
................@.............@.........
..........@@.................@@.........
29
4 29 0
33 33 0
24 19 0
34 11 0
33 5 0
29 32 0
9 34 0
1 36 0
37 37 0
2 7 0
21 10 1
36 12 1
24 11 1
24 20 1
19 12 1
28 12 1
18 24 1
17 18 1
16 19 1
25 8 1
0 38 2
27 24 2
6 26 2
6 1 2
25 16 2
24 29 2
34 9 2
36 26 2
22 30 2

15 32 0
0 0 0
3 5 0
1 10 0
34 3 0
15 30 0
2 29 0
7 25 0
34 2 0
38 37 0
25 36 1
9 37 1
18 10 1
11 38 1
8 28 1
24 21 1
9 1 1
36 39 1
19 18 1
37 32 1
9 33 2
23 6 2
6 19 2
1 2 2
30 19 2
8 4 2
5 33 2
28 20 2
18 1 2
