width 20
height 20
....@.....@.........
....................
..........@.........
.@.....@............
...@....@......@....
...........@........
....................
..............@.....
........@....@......
..........@......@..
........@...........
....@.......@....@..
...@...@......@.....
....................
.....@...@...@....@.
.@......@..@..@..@..
....................
...@...@...@.@......
.............@......
....................
1
2 2 0

16 7 0
