width 20
height 20
............@.......
...@................
....................
....................
.@.............@.@..
....................
....@........@......
...@..@........@....
.@........@.@.......
....................
...@....@...........
....................
....................
.@................@.
...@.........@......
....................
.......@......@.@...
....................
....@....@@@@@......
..........@@@@@.....
5
13 1 0
5 0 0
16 11 0
4 15 0
11 5 0

13 1 0
5 6 0
9 0 0
16 3 0
6 12 0
