width 20
height 20
..........@.........
...............@....
....@.........@.....
...............@....
....@...@..@......@.
....................
.@.........@..@.....
@..................@
...@..@.............
@.@..@..@.......@...
@..........@........
@@@................@
....@........@..@...
........@...........
...........@........
..........@.......@.
........@...........
....................
.......@........@@@.
........@.......@@@@
13
9 19 0
0 16 0
0 4 0
12 15 0
2 3 0
17 6 0
14 18 0
8 1 0
15 9 0
11 13 0
9 11 0
6 13 0
1 15 0

8 18 0
19 3 0
2 16 0
17 8 0
4 15 0
7 15 0
1 5 0
7 9 0
15 9 0
11 13 0
5 11 0
1 13 0
3 15 0
