width 20
height 20
.....@@@............
....................
....................
......@....@.....@..
....@.........@.....
......@@...@........
.....@@.@......@.@..
..@...........@.....
......@.............
.@................@.
..........@......@..
...@..@.............
.........@...@......
...........@..@.....
.@......@...........
............@.......
....................
..@@@.....@.........
..@@@...............
...@................
13
13 10 0
18 2 0
8 18 0
12 17 0
1 11 0
11 8 0
15 5 0
5 8 0
5 7 0
6 15 0
18 7 0
2 3 0
15 9 0

0 0 0
15 13 0
10 7 0
6 16 0
5 18 0
7 11 0
10 18 0
5 13 0
4 10 0
19 2 0
16 9 0
19 8 0
4 1 0
