width 20
height 20
@@..................
...........@........
.............@......
....@...............
....................
.....@...........@..
...........@........
..@.......@.........
.......@............
.........@......@.@@
@............@.@....
@......@............
...@........@.......
.....@........@...@.
........@..@........
....................
..............@.....
...........@........
......@.............
...........@@.......
13
18 1 0
18 17 0
11 5 0
6 3 0
3 17 0
12 15 1
3 2 1
9 7 1
5 11 1
7 4 2
14 18 2
10 5 2
2 5 2

0 6 0
0 2 0
9 12 0
18 14 0
13 19 0
7 19 1
0 8 1
15 6 1
3 8 1
6 5 2
13 5 2
15 13 2
12 15 2
