width 20
height 20
....................
..........@...@.....
@...................
...........@...@....
........@...@.......
...@................
..@...........@.....
...........@....@...
..........@.........
....................
.@.....@............
.....@.....@....@...
.......@.@.@........
..@..@.............@
...................@
.@.................@
................@...
....@....@.@........
..............@.....
........@...........
10
19 2 0
12 18 0
6 11 0
12 6 0
11 0 1
9 19 1
5 8 1
4 7 2
4 15 2
14 11 2

1 16 0
8 11 0
19 0 0
14 7 0
12 0 1
2 16 1
4 0 1
14 12 2
3 13 2
0 14 2
