width 20
height 20
....................
.......@.......@....
..@......@...@....@.
...........@.@......
......@.............
..@..@.....@........
..........@.........
.................@..
...@.@.......@..@...
............@.......
.@.............@....
..................@.
...@..@......@......
....@............@..
......@.....@......@
................@...
..........@.........
............@...@...
.@..@@@...@.........
....@@@.............
10
3 0 0
3 17 0
19 8 0
1 3 0
16 3 1
14 14 1
17 4 1
8 5 2
19 3 2
18 14 2

15 11 0
12 18 0
17 16 0
1 3 0
13 11 1
3 3 1
2 15 1
12 1 2
2 19 2
18 12 2
