width 20
height 20
.........@@........@
.........@@.......@.
....................
..@...@..........@..
.........@.@@.......
........@...........
...@.@..............
.@..................
.........@..........
............@.......
.........@..........
.@...........@..@...
...@...@............
@....@..............
....@......@..@.....
....................
........@.@.@.......
...@..@..@..........
...@@...........@...
...@................
10
3 4 0
16 1 0
17 1 0
12 8 0
2 2 1
7 16 1
18 17 1
19 9 2
11 7 2
3 5 2

1 8 0
14 11 0
6 8 0
1 0 0
5 19 1
19 1 1
13 19 1
7 1 2
1 6 2
19 14 2
