width 20
height 20
....................
...@...............@
...............@....
....@...............
.......@......@.....
..@.....@.@.....@...
...........@..@.....
....@.....@..@......
..@......@..........
.................@..
...............@....
....@....@..........
.......@.......@..@.
.................@..
.@..............@...
..............@.....
......@........@....
....@..@............
@...................
@...................
7
5 2 0
8 2 0
3 15 0
1 19 0
10 8 0
1 7 0
9 13 0

18 13 0
18 19 0
13 5 0
16 15 0
11 12 0
17 0 0
5 18 0
