width 20
height 20
@.@@@.......@@......
....................
........@...........
@.....@.......@..@.@
....................
.............@.@....
.....@...@..@....@.@
...................@
....................
............@..@....
....................
....@.....@.........
.........@.@........
....................
.......@@..@........
......@@............
.....@@@.@..........
............@......@
..............@.....
....@...............
2
18 6 0
11 13 1

8 4 0
3 1 1
