width 20
height 20
....................
....................
...............@....
@.........@........@
.......@.@.@......@.
....@...........@...
...@.@.............@
........@...@.......
@@....@...@.........
@@..@.........@.....
@@..................
...@.....@.@.@......
.......@............
....................
..@....@............
.........@.....@....
...@..........@.....
.........@..........
..........@...@.....
....@.@.............
8
2 18 0
1 6 0
12 5 0
5 18 1
3 13 1
6 7 1
13 0 2
4 14 2

5 13 0
11 8 0
6 9 0
8 5 1
5 10 1
11 15 1
15 12 2
17 9 2
