width 20
height 20
........@@@.........
..@.....@@........@.
.........@..........
......@..@..@.......
...@.@............@.
.@...........@......
..@..@.....@........
@............@......
..........@....@....
.............@......
.......@..@.........
@................@..
@@.........@...@....
@@..................
@...................
.........@........@@
.........@........@@
...........@........
@@...........@......
@@...........@@@@@@.
8
5 3 0
2 18 0
7 1 0
11 5 1
16 4 1
19 1 1
4 0 2
5 17 2

4 3 0
8 13 0
17 18 0
19 19 1
14 4 1
17 3 1
2 2 2
14 10 2
