width 20
height 20
@@@@@@@@@@@@@@@@@@@@
@@@@@@@@@@@@@@@@@@@@
@@@@@@@@@@@@@@@@@@@@
@@@@@@@@@@@@@@@@@@@@
@@@@@@@@@.@@@@@@@.@@
@@@@@@@@..@@@@@@...@
@@@@@@@.@...@@@..@.@
@@@@@.....@.@@.@..@@
@@@@@@.@@.@....@.@@@
@@@@@..@.@..@@@....@
@@@@@@...@@.@.@@.@.@
@@@@@..@.@@@..@..@..
@@@@@@.@..@@@..@..@.
@@@@@@@@.@.@.@...@.@
@@@@@@@@.@...@@.@@.@
@@@@.@...@@@........
@@@....@..@..@@.@.@@
@@@@.@.@.@@.@....@@@
@@@...@@.....@.@..@@
....@@@@@@.@.@.@.@@@
4
17 7 0
10 6 0
6 9 0
8 16 0

17 16 0
8 15 0
9 8 0
10 13 0
