width 20
height 20
@@@@@@@@@@@@@@.....@
@@@@@@@@@..........@
@@@@@@@..@..........
@@.........@........
...............@....
...........@........
...@......@.........
.......@.@..........
.@....@.............
@...............@@..
@@..@....@.@....@@..
@@...@..@...........
@@.............@....
@@..................
...@....@....@......
..........@.@.......
...@...@...@........
...................@
...@................
....@...............
8
15 15 0
4 7 0
7 13 0
9 12 1
8 4 1
17 15 1
9 17 2
18 3 2

19 19 0
2 5 0
8 7 0
2 14 1
0 16 1
13 2 1
14 14 2
12 2 2
