width 20
height 20
......@@@@@@@@......
......@@@@@@@@......
...........@.@.....@
................@...
...........@........
...@.@..............
........@...........
............@...@...
...@...@.@.....@....
....................
......@.....@.......
...@.......@....@...
..............@.....
...@....@...........
.....@...@.@.....@..
..............@.....
....................
.......@....@.......
..@.................
....@...............
7
8 2 0
6 19 0
1 10 0
19 5 0
2 2 0
11 8 0
9 5 0

7 5 0
18 0 0
1 10 0
19 5 0
13 17 0
9 15 0
12 4 0
