width 20
height 20
....................
@...................
@@.@...@............
..@..............@..
..........@.........
......@......@......
@......@.@..........
@.......@........@..
@.....@.............
............@..@....
.....@..@.@.........
...............@....
.....@.............@
............@..@....
..@@..@.........@...
....................
....@..........@....
........@...........
....................
....................
7
12 1 0
3 17 0
17 12 0
18 10 0
14 19 0
0 15 0
14 8 0

14 7 0
16 5 0
9 0 0
8 8 0
13 17 0
14 0 0
2 19 0
