width 20
height 20
....................
.......@......@.....
@.......@...........
@..@...........@....
...............@...@
.@......@@..........
..@........@...@....
.............@....@.
...@...@............
............@.......
.............@......
.................@..
......@.@..@........
.................@..
.......@....@..@....
..@.......@......@..
.............@......
.......@............
.....@.........@....
.....@..............
7
16 1 0
13 6 0
18 4 0
13 0 0
5 5 0
16 4 0
13 18 0

2 7 0
12 1 0
1 17 0
15 0 0
12 2 0
16 9 0
10 12 0
