width 20
height 20
.......@@...........
....@............@..
......@.............
.....@...@..........
............@..@.@..
........@...........
.......@......@.....
.@....@.............
@@.......@..........
@..............@....
.@......@...........
....@..@............
..............@.@...
...@................
.........@.@........
..@.@.@...........@.
...@................
............@.......
......@....@....@...
....................
2
1 14 0
11 3 0

18 4 0
0 18 0
