width 20
height 20
....................
....................
.@..........@.@....@
..@.@...............
@.......@...........
@.........@.........
@.....@.......@.....
.........@..........
..@...........@..@..
@@@....@............
...........@.@.@....
.@....@.............
....................
........@..@.@...@..
.......@........@...
..@...........@.....
.....@..............
.@@@@...........@...
@@@@@..........@.@..
@@@@@..............@
2
7 19 0
17 5 0

19 5 0
14 18 0
