width 20
height 20
....................
....@...............
..........@.......@.
.......@.....@......
..@...........@.....
...........@........
......@.............
....................
.....@..............
.........@@.........
.....@..............
.......@.@..@...@...
...@....@...........
.......@............
....................
.@....@.......@..@..
....................
...@..@.............
.........@..........
..............@@@...
3
17 2 0
16 15 0
7 8 0

17 8 0
8 10 0
7 14 0
