width 20
height 20
@@@@@@@@@@@@.@@@@@@@
@@@@@@@@@@@...@@@@@@
@@@@@@@@@@@@.@.@@@@@
@@@@@@@@@@@@....@@@@
@@@@@@@@@@...@@@.@@@
@@@@@@@@@@@@.@.@..@@
@@@@@@@@@@@@.@...@@@
@@@@@@@@..@....@..@@
@@@@@@@@@.@.@.@..@@@
@@@@@@....@..@.@....
@@@....@@...@@..@.@@
@@@@.@..@@.@@@.@...@
@@...@.@@@@@@....@@@
@@@.@........@@@..@@
@@@@@@.@@.@@@....@.@
@@@@@@...@@@@@@@....
@@@@@@@.@@@@@@@@@@.@
@@@@@@@@@@@@@@@....@
@@@@@@@@@@@@@@@@.@..
@@@@@@@@@@@@@@@@@@.@
11
9 7 0
10 4 0
18 15 0
11 4 0
13 1 1
12 13 1
18 14 1
16 11 1
14 14 2
16 14 2
11 10 2

19 18 0
6 9 0
7 16 0
12 7 0
11 13 1
16 7 1
18 16 1
17 17 1
19 15 2
14 12 2
11 9 2
