width 20
height 20
@@@@@@@..@@.@..@@@@@
@@@@@@..@@@..@..@@@@
@@@@@..@@@@.@..@@@@@
.@@.@@.@@@..@.@@@@@@
.@@.....@..@@..@@@@@
.@@.@@.@.@....@@@@@@
.....@@@.@.@.@@@@@@@
.@.@.@.....@.@@@@@@@
..@....@.@@@@@@@@@@@
@@.@.@..@@@@@@@@@@@@
.@.@@..@@@@@@@@@@@@@
.@....@@@@@@@@@@@@@@
...@.@@@@@@@@@@@@@@@
@.@@@@@@@@@@@@@@@@@@
@@@@@@@@@@@@@@@@@@@@
@@@@@@@@@@@@@@@@@@@@
@@@@@@@@@@@@@@@@@@@@
@@@@@@@@@@@@@@@@@@@@
@@@@@@@@@@@@@@@@@@@@
@@@@@@@@@@@@@@@@@@@@
11
8 7 0
10 3 0
0 10 0
9 4 0
6 7 1
2 6 1
6 9 1
3 6 1
3 3 2
4 4 2
12 1 2

8 7 0
13 5 0
0 12 0
2 6 0
6 7 1
11 1 1
5 11 1
13 3 1
0 6 2
6 3 2
13 2 2
