width 20
height 20
@@@@@@@...@.@@@@.@.@
@@@@@@.@@....@@@.@.@
@@@@@....@.@@@@.....
@@@@@@.@.....@.@@@@.
@@@@@@.@.@.@....@.@.
@@@.@...@@@@@@@.....
@@@.@@.@.@@@.@@.@.@.
@@@...........@@@.@@
@@@@.@.@@@.@@...@...
@@@...@....@@.@@..@.
@@@@@@@.@@.@.@@@.@..
@@@@......@...@...@.
@@@@@.@.@...@@@@.@@@
@@@@@..@..@...@@.@@@
@@@@@@@@.@@@@..@..@@
@@@@@@@@@@@@@@@@.@..
@@@@@@@@@@@@@@@....@
@@@@@@@@@@@@@@.@@.@.
@@@@@@@@@@@....@@.@.
@@@@@@@@@@..@@......
11
16 0 0
16 2 0
9 3 0
19 4 0
17 17 1
14 8 1
18 15 1
7 2 1
18 2 2
6 2 2
15 2 2

18 5 0
9 0 0
10 19 0
5 13 0
8 14 1
10 7 1
7 12 1
10 4 1
9 11 2
6 2 2
8 11 2
