width 20
height 20
...@..@...........@.
....................
...................@
.@.................@
..............@.....
................@...
........@..@........
..@...........@.@...
....................
..........@...@...@.
.............@......
......@.............
.....@...@......@...
........@@@......@..
@......@@@@....@....
@.....@.@...........
@@@@.......@........
@@@@................
@@@@@...............
@@@@@@............@@
3
12 5 0
8 2 1
11 7 2

1 15 0
5 2 1
11 7 2
