width 20
height 20
...@@..............@
.........@..@......@
..@...........@.....
....................
.....@....@.........
..............@.....
....@.......@.......
.....@...........@..
.........@.....@....
...@................
....................
@..........@........
...@..............@.
....@...............
.......@.@..@.....@.
@...................
@.........@...@.....
............@....@@@
.....@..........@@@@
.................@@@
3
2 9 0
12 2 1
11 8 2

19 2 0
11 5 1
0 19 2
