width 20
height 20
@@@@@@@@@@@@@@@@@@@@
@@@@@@@@@@@@@@@@@@@@
@@@@@@@@@@@@@@@@@@@@
@@@@@@@@@@@@@@@@@@@@
@@@@@@@@@@@@@@@@@@@@
@@@@@@@@@@@@@@@@@@@@
@@@@@@@@@@@@@@@@@@@@
@@@@@@@@@@@@@@@@@@@@
@@@@@@@@@@@@@@@@@.@@
@@@@@@@@@@@@.@@@...@
@@@.@@@@@.....@.@.@.
@@@...@..@@.@.@.....
.@@@.@.@..@@@.@.@@@.
........@.@.@.@.@.@@
.@@@.@@.......@....@
..@.@@.@@.@@@...@.@@
.@.........@..@@....
@..@.@.@.@.@@.@@@.@.
@@.@@@@@@..@@..@@@..
@@...@@@@@.@..@@@@@.
3
11 13 0
8 14 0
0 14 0

3 11 0
9 18 0
13 19 0
