width 20
height 20
@@@@@@@@....@@@@@@@@
@@@@@@@@@@@.@@@@@@@@
@@@@@.@@@....@@@@@@@
@@@@......@.@@@@@@@@
@@@.@.@.@@...@@@@@@@
@....@@.@.@.@@.@@@@@
..@.@@.@@......@@@@@
.@........@@@.@@.@@@
@..@@@.@@..@..@...@@
@@....@@@.@@.@.@.@@@
@@@.@.@@@..@...@..@@
@@@.@@@@@@..@@...@@@
@@@..@.@@@.@@..@.@@@
@@@.@@..@@.@@@..@@@@
@@@@@@.@....@.@.@@@@
@@@......@.@@...@@@@
@@@@.@.@..@...@@@@@@
@@@@@.@@.@@@@@@@@@@@
@@@@@.....@@@@@@@@@@
@@@@@@@.@..@@@@@@@@@
3
4 9 0
8 18 0
9 0 0

8 3 0
15 11 0
6 6 0
