width 20
height 20
....................
............@.......
.......@.@...@......
....................
...............@.@..
...........@........
..@...............@.
.......@..@.@..@....
.............@......
.......@...........@
.........@.........@
.@..@..........@....
...................@
..........@......@..
...........@....@@..
.........@..........
.@..........@.......
..............@.....
....................
......@@............
3
13 5 0
0 17 1
11 8 2

0 18 0
15 3 1
10 18 2
