width 20
height 20
@@@@...............@
....................
..@..............@..
................@...
.......@...@........
.@..@......@@.......
.........@..@....@..
............@.@...@@
..................@@
....@............@@@
...........@......@@
......@......@....@.
...............@....
..@.................
....@...............
...@........@....@..
........@..@........
.@...........@......
....................
....................
3
14 16 0
0 17 1
19 14 2

4 2 0
0 18 1
2 16 2
