width 20
height 20
@@@@@@@@@@@@@@@@@@@@
@@@@@@@@@@@@@@@@@@@@
@@@@@@@@@@@@@@@@@@@@
@@@@@@@@@@@@@@@@@@@@
@@@@@@@@@@@@@@@@@@@@
@@@@@@@@@@@@@@@@@@@@
@@@@@@@@@@@@@@@@@@@@
@@@@@@@@@@@@@@@@@@@@
@@@@@@@@@@@@@@@@@@@@
@@@@@@@@@@@@@@@@@@@@
.@..@.@@@@@@@@@@@@.@
.@@.....@@@@.@@@@..@
.@@@.@.@.@@...@@..@@
.@@.@.......@.@.@..@
......@.@@@.@.....@.
@.@.@.@.@@...@.@.@@.
@..@...@@@.@@@@.....
..@@@.@@@@.@..@@.@.@
@.@@.@.@@.@.@.@.@@..
.....@.............@
7
14 14 0
10 13 0
15 19 0
16 14 1
18 17 1
2 19 2
12 12 2

10 16 0
4 19 0
14 19 0
2 16 1
10 17 1
15 18 2
15 16 2
