width 40
height 40
.....@@@@...............................
..............@.@..@......@.............
.@..............@@......................
..........@..@........@.........@.@.....
......@..............................@..
.........@.....@.@.........@..........@.
......@.......@........@.....@..@......@
........@........@.....................@
..............@..................@..@...
...@....@.@..@.@..@..@....@.@...........
....@............@...............@......
............@..............@..@.........
.@..................@....@..............
..........@.........................@...
..@.....@.........@......@.....@........
@........@..........@..@................
...@..........@...............@.........
.....@..........@.@.....................
..@....................@@....@....@.....
.....@..........@........@.@........@@..
........@.........@.@@@.........@.......
....@.......@..@.@......@..@..@...@.....
......@...............@@@...............
.....................@@@@....@..........
........@.......@........@@.............
..............@..@...@.@....@...........
............@......@.........@.......@..
...@.@.@.........@......................
...........@..........@.........@.......
........@.@......................@......
....@........@.@...@..@.@....@..........
.@.....@...@......@.............@...@...
..@.....................@.....@.....@@..
....@..@.........@......................
...@..........@.....................@.@.
..................@.........@.@..@......
.....@.@.@..............@.@.....@.......
................@..@................@...
...@......@.............@...............
........................................
20
28 36 0
3 28 0
30 31 0
24 39 0
5 15 0
21 10 0
15 35 0
9 9 1
23 12 1
16 27 1
30 23 1
19 4 1
18 36 1
26 39 1
8 11 2
24 10 2
1 38 2
6 29 2
0 0 2
7 5 2

39 15 0
8 28 0
24 20 0
26 26 0
31 25 0
7 35 0
39 0 0
9 8 1
12 8 1
11 25 1
3 22 1
31 4 1
12 3 1
21 29 1
13 18 2
11 22 2
5 32 2
4 28 2
37 22 2
16 21 2
