width 20
height 20
.@@@@.......@@@@....
..@@....@........@..
.....@.........@....
....................
....................
..............@.....
....@.....@.........
..@.@...@....@......
............@....@..
..........@.........
.@.@..........@.....
.......@....@.......
..@........@..@.....
................@...
.@....@.....@.@.....
...........@....@...
...@.@...........@..
....@...@...........
@@..................
@@@@................
13
12 17 0
9 8 0
15 3 0
4 10 0
12 3 0
7 19 1
7 0 1
18 6 1
2 14 1
7 13 2
5 14 2
13 12 2
18 12 2

15 16 0
13 17 0
19 13 0
19 2 0
6 11 0
17 4 1
9 13 1
0 13 1
6 18 1
17 5 2
4 13 2
4 3 2
11 4 2
