width 20
height 20
....@@..............
........@....@......
....................
....................
......@....@........
@....@....@...@..@..
@...................
@.....@..@..........
.....@..@.........@.
..................@@
@............@....@@
...@...@........@@@@
............@......@
.........@..........
..............@.....
............@.......
..@.................
....@...............
............@.......
@...................
6
1 9 0
9 15 0
9 9 0
9 1 0
16 7 0
19 6 0

1 9 0
1 5 0
0 15 0
12 6 0
10 11 0
14 9 0
