width 20
height 20
@........@....@@...@
....................
......@......@.@....
@@..@...@...........
.....@..........@.@.
..........@..@@..@..
..@..@.........@....
...........@........
.............@......
........@...........
..........@@..@.....
........@.........@.
...@......@.........
..@....@.....@...@@.
.....@..@...@....@@.
.@..@.....@......@@@
.....@.......@......
......@.............
.............@....@.
...........@........
6
9 15 0
19 18 0
0 17 0
13 14 0
10 18 0
0 9 0

9 12 0
19 18 0
17 4 0
16 17 0
7 11 0
6 19 0
