width 20
height 20
@@.....@...@@@@@@@@@
@@@@.@...@@.@@@@@@@@
@@@@@..@......@.@@@@
@@.@.@@@@.@.@....@@@
@@.@..@.@@@@..@.@@@@
@@...@@..@@.@.@@@@@@
@@@@.@..@.......@@@@
@@.@...@.@@.@.@@@@@@
@....@....@.@@@@@@@@
@@@@.@@.@......@@@@@
@@.@@..@@@.@.@.@@@@@
@...@@.@@.@...@@@@@@
..@.....@.@@.@.@@@@@
@..@@@@@@....@..@@@@
@.@.@@.@@@@.@.@.@.@@
....................
@.@.@.@@@@@@.@.@.@@.
@@@@@@@@@@....@@@...
@@@@@@@@@@@@.@@@@@@.
@@@@@@@@@@@@@@@@@@@.
2
5 16 0
10 10 1

9 9 0
12 17 1
