width 20
height 20
..@@@@@...@@@@@@@@@@
@.@@@.@.@@@@@.@@@@@@
...@......@@..@@@@@@
.@.@@.@@@.@.@..@@@@@
@.....@.......@.@@@@
@@@.@.@.@.@.@....@@@
@....@@@.@@@.@@@.@.@
@@.@@....@@........@
.@...@.@....@@.@.@@@
...@@@..@@.@@@@.@@@@
.@..@@@.@.@@@@@...@@
..@@.@@...@.@@.@.@.@
.@......@..........@
@.@.@.@..@@.@@@@.@.@
..@@.@.@...@@@@..@..
.@.@.....@.@@@@@..@.
.....@.@..@.@.@@.@@@
@@.@..@@.@........@@
@@@..@.@.@@@.@@.@..@
@@@@....@@@@@@@@@.@@
2
7 7 0
2 15 1

6 2 0
8 15 1
