width 20
height 20
@@@@@@@@...@@....@.@
@@@@@@@@@.@...@.@...
@@@@@@@@....@.@@.@.@
@@@@@@@@@.@@@.@....@
@@@@@@..@....@..@.@@
@@@@@.@.@@.@..@.@.@@
@.@@....@@@@@....@@@
...@@.@..@@@@.@@@..@
@.@.@@..@@@@.....@..
......@.@.@.@.@@@..@
@.@.@..........@.@..
@..@@@@@.@.@.@.@...@
@@@@@@....@@@...@@..
@@@@@..@.@@@@@.@.@.@
@@@@@@..@@@@@......@
@@@@@@@@@@@@@@.@@.@@
@@@@@@@@@@@@@@@@@@@@
@@@@@@@@@@@@@@@@@@@@
@@@@@@@@@@@@@@@@@@@@
@@@@@@@@@@@@@@@@@@@@
6
13 7 0
13 9 0
14 6 1
14 11 1
7 8 2
5 7 2

13 7 0
6 6 0
5 7 1
14 14 1
19 8 2
11 2 2
