width 20
height 20
@@@@@@@.@.@.@.@@@..@
@@@@@@........@.@.@@
@@@@@..@@.@.@.@.@.@@
@@@@@.@@@@..@@......
@@@@...@@@@@@@@.@@.@
@@@..@.@@@@..@...@@@
..@.@...@@@@...@.@.@
.@.@@@@..@..@@.@....
...@....@.@.@...@@@.
.@..@.@......@.@@@@@
@.@...@@.@.@....@@@@
..@.@.@...@.@.@@@@@@
.@..@.@@@@........@@
..@..@@@@.@@.@.@.@@@
@..@@.@@@.....@....@
@@.....@..@@.@@@.@@@
@@@@@.@.@.@@@@@@@@@@
@@@@..@.@.@@@@@@@@@@
@@@@@.@....@@@@@@@@@
@@@.....@@..@@@@@@@@
6
8 11 0
4 4 0
16 5 1
14 7 1
5 12 2
10 19 2

5 19 0
15 5 0
9 17 1
0 13 1
10 10 2
0 6 2
