width 20
height 20
...@@@@@@@@@@@@@@@@@
@@..@@..@@@@@@@@@@@@
...@..@..@@@@@@@@@.@
@@...@..@.@@@@@@@...
@..@..@.....@@@@@.@@
@.@@@...@.@..@@@..@.
@.@@@@.@@@..@.@.@...
...@@@..@@@.......@@
@.@.@..@@@@.@.@.@@@@
@....@@@@..@.@..@@@@
.@@.@.@...@...@@@@@@
.......@@.@.@.@.@@@@
@.@@@@..@....@..@@@@
@@@@@@.@@.@.@@@..@@@
@@@.@..@.@@.@...@@@@
@@...@.@......@@@@@@
@@@@.....@@.@..@@@@@
@@@@@.@.@@@@..@@@@@@
@@@@@@...@@.@.@..@@@
@@@@@@@.@@@.....@@@@
16
5 17 0
1 7 0
3 14 0
1 11 0
9 9 0
7 4 0
13 17 1
5 11 1
19 6 1
6 3 1
11 11 1
15 19 2
12 17 2
2 1 2
16 13 2
5 14 2

4 11 0
2 4 0
7 10 0
13 10 0
19 3 0
1 6 0
12 7 1
10 9 1
1 2 1
6 3 1
1 4 1
14 19 2
15 7 2
6 12 2
11 10 2
2 0 2
