width 20
height 20
@...@@@.@@.@.@.@@@.@
@.@..@..........@...
.@..@@@.@.@.@@.@.@.@
..@..@.@@@..@......@
.@@.@@.@@@@@.@@.@.@@
........@.@@.....@@@
.@.@.@@...@@@@.@@.@@
.@.@@...@.@@......@@
@@@@@@.@.@@@.@.@.@@@
@@@@@@...@@..@.@..@@
@@@@@..@..@@..@..@@@
@@@.@@.@@...@.@@@@@@
@.@...@.@.@...@@@@@@
....@@..@@@.@.@@@@@@
.@@....@.....@@@@@@@
...@.@...@@.@@@@@@@@
.@@@@@@@...@@@@@@@@@
@@@@@@@@@@@@@@@@@@@@
@@@@@@@@@@@@@@@@@@@@
@@@@@@@@@@@@@@@@@@@@
15
3 14 0
3 0 0
17 7 0
17 9 0
14 5 0
6 8 1
2 7 1
13 1 1
10 11 1
3 12 1
5 10 2
3 1 2
10 0 2
11 9 2
16 7 2

11 12 0
11 14 0
1 1 0
12 1 0
4 15 0
13 7 1
13 12 1
17 1 1
13 5 1
14 9 1
9 16 2
9 10 2
3 5 2
1 0 2
6 11 2
