width 20
height 20
.@....@@@@@@@@@.@@.@
...@.@@@@.@.@@@.@...
@.@.@...@...@....@.@
....@@.@.@.@.@.@...@
@.@..........@@.@.@.
...@@.@@.@.@........
@.@@@@....@@@.@@@.@.
@@.@@.@@.@@@@@@@@@..
@@........@@@.@@@@.@
@@@.@.@@.@.....@@@@@
@@@@.@@..@@.@.@@@@@@
@@.@.@@@.@@@...@@@@@
@@.@.@.....@@.@.@@@@
@..@.@@.@.@@....@@@@
.@...@..@.@.@.@@@@@@
...@...@..@.....@@@@
@@.@@.@@@...@@.@@@@@
@@@@@..@..@...@@@@@@
@@@@@.@@@..@.@@@@@@@
@@@@@@@@@@@@@@@@@@@@
15
0 1 0
17 1 0
7 8 0
12 13 0
18 1 0
8 7 1
5 16 1
13 2 1
11 14 1
9 2 1
8 8 2
10 9 2
0 5 2
11 17 2
9 12 2

11 9 0
0 5 0
13 17 0
6 14 0
9 16 0
12 5 1
6 8 1
5 2 1
18 5 1
2 15 1
12 3 2
18 2 2
2 1 2
8 8 2
2 5 2
