width 20
height 20
......@.@...........
................@...
..............@.....
.................@..
...............@....
.@.......@..........
..@................@
.................@.@
......@...@.@.@.....
..@.................
............@.......
..@...@..@..........
................@@..
....@.........@.....
...@................
.@...........@......
.......@.......@....
...@..............@.
......@........@....
....@.....@@@@......
3
9 16 0
7 12 1
18 13 2

19 0 0
12 0 1
17 6 2
