width 20
height 20
....................
....................
..@..@........@.....
....................
..........@.........
@@....@.............
@@..@.....@......@..
@@..................
@......@............
....................
@@..@.@..........@..
...........@........
..@.................
...@......@.....@..@
........@..@........
..............@.....
......@........@....
.....@......@.......
@@..@...............
@@...............@@@
3
0 14 0
12 11 1
14 8 2

0 17 0
6 11 1
0 15 2
