width 20
height 20
.......@@........@@@
..........@....@.@@@
.............@......
............@..@....
....................
...........@....@.@@
.@.@...@......@...@@
..........@.........
....................
......@....@........
............@.......
.........@......@...
...@........@.......
.......@......@.....
....................
......@....@.@......
.@@.......@.....@..@
.@@.@...@...........
..@...........@.....
....................
3
6 3 0
2 12 1
6 11 2

3 13 0
17 16 1
2 12 2
