width 20
height 20
............@@@...@@
......@.....@@@....@
..@..@..@...@@@.....
...@........@@@....@
........@.....@.....
..................@@
.........@..........
...........@........
...@.@.........@....
..............@...@.
.@..@....@...@......
..........@.@.......
.......@........@...
....@.........@.....
......@.........@...
@@@.......@.......@.
....................
......@@@.@.........
....@@@@@@...@......
....@@@@@@..........
3
2 14 0
11 10 1
15 16 2

19 4 0
1 17 1
13 19 2
