width 20
height 20
@@@@@@@@@@@@@@@@@@@@
@@@@@@@@@@@@@@@@@@@@
@@@@@@@@@@@@@@@@@@@@
@@@@@@@@@@@@@@@@@@@@
@@@@@@@@@@@@@@@@@@@@
@@@@@@@@@@@@@@@@@@@@
@@@@@@@@@@@@@@@@@@@@
@@@@@@@@@@@@@@@@@@@@
@@@@.@@@@@@@@@@@@@@@
@@....@@@@@@@@@@@@@@
@@@@.@@@@@@@@@@@@@@@
@@....@@@@@.@.@@@@@@
@@@.@...@........@.@
@@@@..@@@.@@@@.@...@
@@@@@.....@@....@@@@
@@@@@.@.@@...@@....@
@@@@@@@@@@.@..@.@.@@
@@@@@.@.@@..@@@@..@@
@@@@.......@@@@@@.@@
@@@@@@@.@.@@@@@@@...
1
4 11 0

6 14 0
