width 20
height 20
@@@@@@@@@@@@@@@@@@@@
...@@@@@@@@@@@@@@@@@
@.@.@@@@@@@@@@@@@@@@
.....@@@@@@@@@@@@@@@
@.@@@.@.@@@@@@@@@@@@
@.@.@.@..@@@@@@@@@@@
........@@@@.@@@@@@@
.@.@@.@.......@@@@@@
..@..@@.@.@.@..@@@@@
@...@@@@@@.@..@@@@@@
@.@@@@.......@@@@@@@
.@@.@@.@.@.@@..@@@@@
.......@@..@.@..@@@@
.@@.@.@@@.@....@@@@@
..@..@@@..@.@@@@@@@@
@@..@.@.@......@@@@@
@@@.....@.@.@.@@@@@@
@@@.@@.@@@...@@@@@@@
@@@@@@@@@@@.@.@@@@@@
@@@@@@@@@@.....@@@@@
1
11 16 0

15 12 0
