width 20
height 20
.........@.......@@@
....@.........@..@@@
........@.........@@
.........@..........
............@.......
......@.....@..@....
.........@......@...
....................
......@....@..@.....
...............@....
........@@..........
...@....@@..........
.................@..
....@.........@.....
...@.........@......
.......@............
....@........@......
.....@.@@.@......@..
..............@.....
@........@...@@.....
1
12 15 0

11 19 0
