width 20
height 20
@...................
.......@.......@....
..........@.........
...@............@.@.
.........@..........
.......@..@.....@...
....@..........@.@..
...@.......@..@.....
..@.......@.........
.....@.......@....@.
....@.@..........@..
.@..........@.......
.............@......
................@...
......@........@....
@..................@
@................@..
.....@.....@........
....................
...@..@.............
1
8 0 0

9 16 0
