width 20
height 20
@@..................
@...................
..................@.
...@................
.....@.@......@.....
....................
...........@........
.....@...@...@....@.
........@.....@....@
...................@
....@......@.....@..
...@..@@............
......@@.....@...@..
....................
..........@.@...@...
...........@........
.....@..............
............@.@.....
................@...
@......@.........@..
11
17 15 0
11 14 0
11 17 0
4 11 0
19 16 1
6 2 1
16 6 1
10 19 1
18 19 2
17 14 2
5 13 2

1 15 0
10 19 0
13 14 0
0 5 0
16 4 1
19 19 1
16 6 1
11 0 1
8 3 2
12 13 2
18 18 2
