width 20
height 20
....................
....................
......@.........@...
....................
..@..@......@...@...
...........@........
@@............@.....
.......@.@..........
...@.........@......
..@....@....@.....@.
.............@..@...
...@...........@....
......@...@......@..
...........@........
.....@..........@...
..............@.....
..@.................
........@..@...@....
....................
....................
11
16 6 0
8 11 0
2 7 0
18 11 0
1 14 1
15 15 1
14 17 1
17 7 1
16 0 2
0 10 2
12 3 2

0 19 0
8 11 0
13 14 0
0 3 0
9 2 1
14 16 1
15 16 1
6 17 1
3 7 2
7 4 2
12 0 2
