width 20
height 20
......@....@@....@@@
..................@@
.....@..............
.@..................
....................
.............@......
..@....@........@...
@...@.....@.........
@.....@..@...@....@.
.................@..
............@.......
..@..@...@....@.....
..............@.....
.........@...@......
......@.............
.........@..@.......
....................
....@.......@....@..
@..................@
@..................@
2
5 7 0
0 2 0

5 7 0
0 2 0
