width 20
height 20
.............@...@..
....................
............@.....@.
..@.................
............@.@..@..
........@.@....@....
..............@.....
....@...............
........@......@....
.......@@...@.......
......@...@........@
...............@....
...@.@..............
@......@..@.@....@..
................@...
...@....@...........
............@..@....
....................
....................
.....@@@..@.........
2
9 6 0
0 15 0

9 6 0
18 3 0
