width 20
height 20
........@..........@
.........@........@.
.............@......
.......@......@.....
........@...........
..@.@...............
.....@..............
...@.....@......@...
....................
@...............@...
..@.......@....@....
.....@............@.
...........@........
...@.........@....@.
........@...........
.........@..@.......
.............@......
....@.@....@...@.@..
................@...
.....@..............
2
7 2 0
18 18 0

19 12 0
16 19 0
