width 20
height 20
.................@@@
..@..@.........@.@@@
.............@.....@
...@..@.............
@...........@.......
...............@....
....@.@.@..@........
..@.........@.......
....................
............@.....@.
....@...............
.......@..@.........
....................
...........@........
......@.............
..........@@....@...
.................@..
.....@..............
....@...............
........@@....@.....
2
13 11 0
11 16 0

12 1 0
0 0 0
