width 20
height 20
@@@@@@@@@@@@.@.@.@..
@@@@@@@@@@@........@
@@@@@@@@@@@.@@@@.@..
@@@@@@@@@@..@@@..@@.
@@@@@@@@@@@.@@.@@@.@
@@@@@@@.@@..........
@@@@@......@.@@.@.@@
@@@@@@@.@@@@@...@...
@@@@@@@.@@@@@@@@..@.
@@@@@@@@@@@@@@@@.@..
@@@@@@@@@@@@@@...@@@
@@@@@@@@@@@@@@@@...@
@@@@@@@@@@@@@@@@.@.@
@@@@@@@@@@@@@@@@@...
@@@@@@@@@@@@@@@@@@.@
@@@@@@@@@@@@@@@@@..@
@@@@@@@@@@@@@@@@@@..
@@@@@@@@@@@@@@@@@@.@
@@@@@@@@@@@@@@@@@...
@@@@@@@@@@@@@@@@@@.@
9
19 5 0
10 5 0
16 11 0
19 16 0
18 15 0
16 12 0
7 7 0
11 1 0
16 8 0

19 3 0
18 5 0
10 6 0
18 16 0
7 6 0
16 9 0
18 15 0
14 0 0
19 8 0
