width 20
height 20
@@@@@@@@@@@@@@@@@@@@
@@@@@@@@@@@@@@@@@@@@
@@@@@@@@@@@@@@@@@@@@
@@@@@@@@@@@@@@@@@@@@
@@@@@@@@@@@@@@@@@@@@
@@@@@@@@@@@@@@@@@@@@
@@@@@@@@@@@@@@@@@@@@
@@@@@@@@@@@@@@@@@@@@
@@@@@@@@@@@@@@@@@@@@
@@@@.@@@@@@@@@@@@@@@
@@@....@@@.@.@@@@@@@
@@@.@.@.@.......@@@@
@@@@......@@.@.@@@@@
@@@@.@@.@.@.@@@.@@@@
@@@@...@@@...@...@@@
@@@@.@..@..@@..@.@@@
@@@@@..@@@...@..@@@@
@@@@@@..@.@.@..@@@@@
@@@@@@@.......@@@@@@
@@@@@@@@@.@@.@@@@@@@
9
14 17 0
6 17 0
13 15 0
3 10 0
6 15 0
9 19 0
9 13 0
9 18 0
4 12 0

14 17 0
15 13 0
14 11 0
5 16 0
7 15 0
4 14 0
8 12 0
11 11 0
14 12 0
