width 20
height 20
............@....@@@
..@@......@......@@@
..................@@
........@.........@@
............@@......
@..........@@....@..
@..@....@.......@...
..@...@...........@.
............@.......
...@.....@...@......
...............@....
.......@............
...........@....@...
....@..@............
...............@....
...@........@.@..@..
........@.........@.
..@....@.@....@.....
....@...............
................@...
12
1 1 0
6 14 0
11 8 0
10 9 0
7 0 1
18 8 1
17 7 1
9 5 1
10 17 2
13 18 2
6 12 2
4 3 2

10 19 0
19 9 0
4 1 0
0 12 0
2 14 1
0 1 1
12 7 1
12 3 1
9 14 2
2 13 2
8 7 2
14 1 2
