width 20
height 20
....................
...........@.@......
@.....@..........@..
...........@........
....................
....@............@..
...............@....
@...@...@.....@.....
....................
...................@
..@........@........
.........@..@.......
.......@............
.@.......@@.....@...
............@.......
...@....@...........
......@.........@...
.....@........@.....
.@......@.@..@......
........@........@..
12
12 13 0
3 7 0
2 18 0
9 14 0
17 10 1
14 1 1
3 16 1
10 5 1
1 2 2
16 9 2
16 3 2
10 12 2

16 18 0
4 16 0
6 7 0
10 3 0
5 11 1
3 16 1
4 9 1
2 13 1
8 10 2
7 1 2
7 6 2
18 0 2
