width 20
height 20
...@@@.@...@...@@@..
....@@..............
.............@......
.......@..@.........
...........@.@......
.......@@.........@.
.......@@...@.......
@..@................
@.........@....@....
.....@...........@.@
..........@.........
@....@............@.
@..........@...@....
..@.....@...........
@............@......
....@......@........
....................
....@..........@.@..
.......@............
......@@..@.........
12
14 13 0
0 2 0
19 15 0
16 5 0
1 1 1
14 18 1
8 7 1
0 5 1
13 18 2
4 3 2
15 3 2
12 10 2

18 4 0
10 15 0
19 1 0
1 12 0
4 8 1
6 12 1
9 8 1
2 9 1
13 17 2
14 1 2
15 5 2
14 10 2
