width 20
height 20
..................@@
...........@......@@
....@...@........@@@
....@............@@@
....................
...........@........
....................
@....@.......@.@.@..
@........@........@@
@..@......@........@
...............@....
....@..@..........@@
..........@........@
.....@.@............
.............@......
....@...@...........
.....@..............
...............@.@..
.....@..........@...
..@@@...............
12
8 8 0
13 0 0
1 9 0
2 4 0
4 1 1
10 13 1
11 17 1
13 5 1
14 6 2
7 2 2
14 8 2
19 4 2

13 17 0
4 14 0
16 14 0
12 17 0
14 18 1
10 15 1
6 0 1
13 0 1
11 18 2
7 3 2
14 10 2
10 6 2
