width 20
height 20
................@@..
...@.@........@..@..
...@......@.........
.................@..
.@......@...@.......
@....@....@.....@...
@@...............@..
.@.@.@..@...........
.............@......
........@.......@.@.
.............@......
....................
..@..@...........@..
.........@..@.......
......@...@.....@...
....................
....@@..............
.......@..@.....@@..
.@..................
....................
12
14 9 0
12 14 0
2 18 0
10 18 0
4 5 1
10 6 1
4 18 1
13 13 1
9 16 2
14 13 2
17 15 2
11 11 2

15 8 0
13 18 0
19 4 0
14 10 0
18 0 1
18 19 1
4 18 1
15 0 1
12 6 2
6 19 2
18 12 2
2 13 2
