width 20
height 20
@@@@@@@@@@@@@@@@@@@@
@@@@@@@@@@@@@@@@@@@@
@@@@@@@@@@@@@@@@@@@@
@@@@@@@@@@@@@@@@@@@@
@@@@@@@@@@@@@@@@@@@@
@@@@@@@@@@@@@@@@@@.@
@@@@@@@@@@@@@@@@@..@
@@@@@@@@@@@@@@@@@@.@
@@@@@@@@@@@@@@.@@..@
@@@@@@@@@@@.....@@.@
@@@@@@@@@@@@@@.@...@
@@@@@@@@@@@@@@...@..
@@@@@@@@@@@@@.@@.@@@
@@@@@@@@.@.@........
@@@@@@...@...@@.@.@.
@@@@@@@@...@..@.@@..
@@@@@@@@@@.@@.@@@@@@
@@@@@@@...@.@.@@@@@@
@@@@@@@@@......@@@@@
@@@@@@@@@.@@.@@@@@@@
12
18 5 0
8 17 0
7 14 0
10 14 0
19 11 1
13 18 1
13 15 1
17 14 1
10 13 2
16 11 2
9 19 2
14 9 2

19 13 0
13 18 0
7 14 0
11 9 0
18 8 1
8 15 1
18 10 1
11 17 1
19 15 2
12 15 2
15 11 2
10 13 2
