width 20
height 20
@@@@.......@@......@
@@@@.@....@@@......@
.....@@..........@..
....................
..@..........@......
..........@.........
........@...........
.@..@.@....@...@....
....................
.........@....@.....
..@.................
...........@...@....
....................
......@....@..@.....
................@...
........@...@......@
...@.......@..@.....
..@.................
....................
....................
12
17 7 0
19 3 0
6 8 0
19 9 0
16 6 1
11 3 1
10 0 1
8 4 1
19 5 2
19 12 2
9 14 2
12 19 2

10 9 0
14 14 0
19 16 0
18 17 0
18 6 1
10 3 1
9 2 1
3 17 1
2 15 2
7 2 2
18 1 2
3 2 2
