width 65
height 81
@@@@@@@@@@@@@@@@@@@@@@@@@@@@@@@@@@@@@@@@@@@@@@@@@@@@@@@@@@@@@@@@@
@@@@@@@@@@@@@@@@@@@@@@@@@@@@@@@@@@@@@@@@@@@@@@@@@@@@@@@@@@@@@@@@@
@@@@@.@@@@@.@@@@@@@.........@@@@@@@@@@@@@@@@@@@@@@@@@@@@@@@@@@@@@
@@@@........@@@@@@..........@@@@@@@@@@@@@@@@@@@@@@@@....@@@@@@@@@
@@@@........@@@@@@@.........@@@@@@@@@@@@@@@@@@@@@@@@...@@@@@@@@@@
@@@.........@@@@@@@..........@@@@@@@@@@@@@@@@@@@@@..........@@@@@
@@@........@@@@@@@@..........@@@@@@@@@@@@@@@@@@@@@..........@@@@@
@@.........@@@@@@@@..........@@@@@@@@@@@@@@@@@@@@@..........@@@@@
@@.........@@@@@@@...........@@@@@@@...@@@@...@@@@............@@@
@@.........@@@@@@@@@.........@@@@@@@....@@@...@@@.............@@@
@@.........@@@@@@@@@..........@@@@............................@@@
@@@............@@@@@..........................................@@@
@@@............@@@@...........................................@@@
@@@............@@@@..........................................@@@@
@@.............@@@@...........@@@@@....@@@.....@@@....@@@@@@@@@@@
@@@@...........@@@@.........@@@@@@@@@@@@@@@@@@@@@@@@@@@@@@@@@@@@@
@@@@.@@@@.....@@@@@@........@@@@@@@@@@@@@@@@@@@@@@@@@@@@@@@@@@@@@
@@@@.@@@@....@@@@@@@........@@@@@@@@@@@@@@@@@@@@@@@@@@@@@@@@@@@@@
@@@@.@@@@....@@@@@...........@@@@@@@@@@@@@@@@@@@@@@@@@@@@@@@@@@@@
@@@@.@@@@....................@@@@@@@....@@@@@@@@@@@........@@@@@@
@@@@.........................@@@@@@@....@@@@@@@@@@@.....@@@@@@@@@
@@@@.........................@@@@@......@@@@@@@@@@@.....@@@@@@@@@
@@@..........@@@@@@..........@@@@@......@@@@@@@@@@@.....@@@@@@@@@
@@@..........@@@@@@..........@@@@@......@@@@@@@@@@@.....@@@@@@@@@
@@@.@@@@@@@@@@@@@@@..........@@@@@@....@@@@@@@@@@@@.....@@@@@@@@@
@@..@@@@@@@@@@@@@@@..........@@@@@@....@@@@@@@@@@@@.....@@@@@@@@@
@@..@@@@@@@@@@@@@@@...........@@@@.....@@@@@@@@@@@@.....@@@@@@@@@
@@..@@@@@@@@@@@@@@@.....................................@@@@@@@@@
@@..@@@@@@@@@@@@@@@.....................................@@@@@@@@@
@@..@@@@@@@@@@@@@@@...........................................@@@
@@@@@@@@@@@@@@@@@@@...........@@@@............................@@@
@@@@@@@@@@@@@@@@@@@...........@@@@@@@@@@@@@@@@@@@@@@@@@@@@@@@@@@@
@@@@@@@@@@@@@@@@@@@...........@@@@@@@@@@@@@@@@@@@@@@@@@@@@@@@@@@@
@@@@@@@@@@@@@@@@@@............@@@@@@@@@@@@@@@@@@@@@@@@@@@@@@@@@@@
@@@@@@@@@@@@@@@@@@............@@@@@@@@@@@@@@@@@@@@@@@@@@@@@@@@@@@
@@@@@@@@@@@@@@@@@@.................@@@@@@@@@@@@@@@@@@@@@@@@@@@@@@
@@@@@@@@@@@@@@@@@@.................@@@@@@@....@@@@@@@.@@@@@@@@@@@
@@@@@@@@@@@@@@@@@@.....................@@@.....@@@.............@@
@@@@@@@@@@@@@@@@@@@............................................@@
@@@@@@@@@@@@@@@@@@@...........................................@@@
@@@@@@@@@@@@@@@@@@@...........................................@@@
@@@@@@@@@@@@@@@@@@@...........................................@@@
@@@@@@@@@@@@@@@@@@@..........................................@@@@
@@@@@@@@@@@@@@@@@@@@..................@@@@@@@@@..............@@@@
@@@@@@@@@@@@@@@@@@@@..................@@@@@@@@@..............@@@@
@@@@@@@@@@@@@@@@@@@@..@@@@.....@@@..@@@@@@@@@@@...............@@@
@@@@@@@@@@@@@@@@@@@@@@@@@@@...@@@@@@@@@@@@@@@@@@@@@...@@@@@@@@@@@
@@@@@@@@@@@@@@@@@@@@@@@@@@@...@@@@@@@@@@@@@@@@@@@@@...@@@@@@@@@@@
@@@@@@@@@@@@@@@@@@@@@@@@@@@...@@@@@@@@@@@@@@@@@@@@@...@@@@@@@@@@@
@@@@@@@@@@@@@@@@@@@@@@@@@@@...@@@@@@@@@@@@@@@@@@@@@@..@@@@@@@@@@@
@@@@@@@@.@@@@@@@.@@@@@@@@@.....@@@@@@@@@.@@@@@@@@@@......@@@@@@@@
@@@@@@@@.@@@@@@@.@@@@@@@..........@@@@@@.@@@@@@@@@@......@@@@@@@@
@@@@@@@@..@@@@@@.@@@@@@@..........@@@@@@.@@@@@@@@@@.......@@@@@@@
@@@@..@@..@@@.@@...@@@........................@@@@@.........@@@@@
@@............................................@@@@@.........@@@@@
@@............................................@@@@@........@@@@@@
@@............................................@@@@@........@@@@@@
@@...........@@.@.............................@@@@.........@@@@@@
@@@..@@......@@@@....@@.......................@@@@...........@@@@
@@@..@@@@@..@@@@@....@@@@.........@@@@@@.@@@..@@@@..........@@@@@
@@@..@@@@@...@@@@....@@@@.........@@@@@@.@@@@.@@@@............@@@
@@@..@@@.......@@...@@@@..........@@@@@@.@@@@.@@@@.....@@@@@@.@@@
@@@.................@@@@@.....@@@@@@@@@@@@@@@@@@@@@@@@@@@@@@@@@@@
@@....................@@....@@@@@@@@@@@@@@@@@@@@@@@@@@@@@@@@@@@@@
@@@@@@@@@@@@@@..............@@@@@@@@@@@@@@@@@@@@@@@@@@@@@@@@@@@@@
@@@@@@@@@@@@@@..............@@@@@@@@@@@@@@@@@@@@@@@@@.......@@@@@
@@@@@@@@@@@@@@................@@@@...........................@@@@
@@@@@@@@@@@@@@...............................................@@@@
@@@@@@.....@@@...............................................@@@@
@@@@@@.....@@@.................................................@@
@@@@@.....@@@@................@@@@.............................@@
@@@@@.....@@@@........@@@....@@@@@.............................@@
@@@@@.....@@@@........@@@....@@@@@.............................@@
@@@@@.....@@@@........@@@@@@..@@@@.............................@@
@@@@@.....@@@@........@@@@@@..@@@@@@...........................@@
@@@@@.....@@@@........@@@@@@..@@@@@@.............................
@@@@@............@@@..@@@@@@.@@@@@@@.............................
@@@@@...........@@@@..@@@@@@@@@@@@@@...@@@@@@@@@@@@@@@@@@@.......
@@@@@...........@@@@....@@@@@@@@@@@@...@@@@@@@@@@@@@@@@@@@.....@@
@@@@@@@@@@@@@@@@@@@@@@@@@@@@@@@@@@@@@@@@@@@@@@@@@@@@@@@@@@@@@@@@@
@@@@@@@@@@@@@@@@@@@@@@@@@@@@@@@@@@@@@@@@@@@@@@@@@@@@@@@@@@@@@@@@@
30
5 12 0
37 40 0
14 61 0
22 28 0
57 53 0
7 72 0
10 57 0
59 70 0
37 9 0
20 16 0
58 6 1
47 11 1
27 17 1
25 15 1
26 67 1
58 68 1
53 10 1
54 27 1
52 52 1
28 27 1
24 12 2
8 13 2
23 30 2
42 36 2
26 60 2
11 61 2
5 70 2
57 29 2
32 57 2
3 55 2

36 39 0
43 66 0
38 41 0
59 76 0
33 69 0
61 8 0
12 55 0
18 71 0
29 11 0
14 15 0
61 77 1
38 27 1
55 21 1
11 60 1
61 11 1
7 10 1
28 5 1
24 44 1
55 44 1
6 56 1
38 9 2
63 77 2
29 31 2
53 75 2
6 3 2
60 43 2
30 57 2
55 26 2
3 5 2
22 7 2
