width 20
height 20
@...................
..........@.........
...............@....
.@..@...............
....................
........@..@..@..@..
............@.......
......@.@...........
............@.@.....
....@..........@....
......@.............
................@...
....@...............
..........@.....@.@.
......@......@......
.....@..............
........@...@..@....
.................@..
....@..@....@.......
.......@@@@.........
13
3 16 0
7 2 0
8 8 0
7 15 0
11 1 0
3 7 0
16 10 0
13 18 0
2 12 0
0 16 0
19 1 0
0 3 0
0 17 0

14 4 0
0 10 0
13 3 0
9 3 0
11 12 0
3 8 0
8 6 0
1 16 0
5 2 0
17 0 0
19 7 0
13 12 0
2 1 0
