width 20
height 20
@@@@@.@@.@@@@@@@.@@@
@@@@......@@@@@@..@@
@@@@@.@@.@.@@@@..@@@
@@@@..@......@@@....
@@@@@@..@@.@@.@..@.@
@@@@@@.@@.......@...
@@@@@@@@.@.@.@@..@.@
@@@@@@.@.@.@@..@@@@@
@@@@@.........@@@@@@
@@@@@@@@.@@.@@@@@@@@
@@@@@@@@@@@@@@@@@@@@
@@@@@@@@@@@@@@@@@@@@
@@@@@@@@@@@@@@@@@@@@
@@@@@@@@@@@@@@@@@@@@
@@@@@@@@@@@@@@@@@@@@
@@@@@@@@@@@@@@@@@@@@
@@@@@@@@@@@@@@@@@@@@
@@@@@@@@@@@@@@@@@@@@
@@@@@@@@@@@@@@@@@@@@
@@@@@@@@@@@@@@@@@@@@
13
11 9 0
18 3 0
6 7 0
10 2 0
19 3 0
6 5 1
5 2 1
16 3 1
13 7 1
7 1 2
8 6 2
17 1 2
7 4 2

12 6 0
12 3 0
8 2 0
7 1 0
17 1 0
13 8 1
6 1 1
11 8 1
8 9 1
16 1 2
17 3 2
16 3 2
8 3 2
