width 20
height 20
.......@............
.................@..
@...........@.......
@......@.@.@........
@................@..
@....@..@...........
@.....@..@.@........
..................@.
...@.@......@.@.....
.................@..
..@..@.......@......
@........@.....@....
....@...........@...
..@....@....@.......
.................@@@
............@.......
.....@..............
..@.....@....@@@.@..
...@.........@......
....................
7
15 2 0
15 12 0
11 13 0
2 15 1
15 16 1
19 19 2
12 11 2

15 2 0
11 11 0
15 4 0
19 3 1
18 10 1
0 0 2
1 16 2
