width 20
height 20
...@..@@@@@@@@@@@@.@
@.@.@..@@@@@@@@@@...
......@@@@@@@@@@@@.@
@.@.@..@@@@@@@@@@...
.@.@.@.@@@@@@@@@.@.@
.........@@@@@@.....
.@.@@.@.@@@@@@.@.@@.
@.@...@@.@@@@@.....@
....@..@..@@@..@.@..
@.@..@...@.@.@.@@..@
@@@@@..@.@...@..@@..
@@@@@@@....@...@.@@.
@@@@@@@@@.@..@@.....
@@@@@@@.@@.@@...@.@.
@@@@@@@.......@..@@@
@@@@@@@.@.@.@@..@@@.
@.@@@@..@..@@..@....
...@@@@..@@..@...@.@
@.@.@@..@..@.@.@..@@
.......@@@.....@.@@@
1
18 17 0

6 10 0
