width 20
height 20
.@.@.@.@@.@@.@.@....
.................@@@
@@.@.@.@@.@@.@.@....
@@.@@@@@@@.@..@..@@@
.@....@@@....@@@....
..@.@.@@@@.@@.@.@.@.
@.@..@@@.........@..
....@@@@@@@.@.@.@@@.
@@@@..@@.@.@.@@.@.@.
..@.@.@.......@...@.
.@......@.@.@.@@@..@
...@.@.@..@@......@@
@.@.@.@@@..@@.@.@@@@
@@..@..@@@...@@....@
@.@..@.@.@.@@@.@.@@@
....@.......@.....@@
@.@...@@.@.@.@.@.@@@
...@@..@@@...@..@@@@
@.@...@@@@.@.@@@.@@@
..@.@..@@..@......@@
1
4 11 0

8 16 0
