width 40
height 40
........................................
.........@........................@.....
.......@...@...@..@.@..@....@@@.@.......
..............................@.........
.....@..................@...........@...
...@..............@......@..@..@..@.....
.@.....@................@.....@..@......
.....@....@...............@.............
....@...@....@.....@.@............@.@@..
.............................@..........
.........@......@..@.@..........@.......
....@...................@...@...........
........@.@..@.............@....@.......
.......@...............@................
..........@.......@......@..............
............@........@........@.@.@.....
.............................@..........
.....@..........@@@@.@..................
.@@.........@...@@@@..@..@...........@..
..........................@....@..@.....
...@..............@..@..................
.....@..@.@.................@......@.@..
.................@...@...@........@.....
...........@.......................@.@..
.......@.................@..............
.@....................................@.
......@.@..@.@...@.....@.@.......@......
....................@.....@...@.@.......
........@.......@...................@...
.@.@@......@.....@.@..@@...@..........@@
.....@.......@..........@...............
.............@...@......@..@.........@..
......@......@................@.........
@...........@..@..@...............@.....
@......@......................@.........
@.....@.@.@......@....@..@..............
.....@.....@....@............@......@.@@
...@.........@.............@....@.......
................@.......................
........................................
8
12 0 0
38 14 0
20 11 0
33 9 0
33 3 0
29 29 0
33 24 0
30 12 0

7 9 0
24 3 0
38 34 0
31 14 0
33 3 0
35 10 0
0 7 0
21 9 0
