width 20
height 20
..@@@@.@@......@..@@
.@@.@...@@@.@.@..@.@
......@...@@...@....
.@.@@..@@@@.@@.@.@.@
@@@@.@.@..........@.
@........@@.@@.@@@..
@@.@.@.@.@@.@.@@@@@.
@...@@.@@......@.@..
@@.@@....@@@.@.....@
@..@.@.@.@..@..@.@..
.@@..@@....@@@@.@..@
.@.@.@@@.@...@..@.@@
.....@@@@@.@.@.@@..@
@@.@..@.@@.@.@.@..@.
@..@.@.....@@@..@.@.
..@.@.@@.@....@.....
.@@.....@@@.@@..@@.@
....@.@.@.@@...@@.@@
@.@@@@..@....@....@@
@.@@@@@...@.@@@.@@@@
11
7 2 0
18 12 0
10 11 0
14 12 0
14 2 0
12 11 0
3 15 0
1 17 0
4 2 0
8 19 0
4 16 0

7 17 0
9 18 0
14 8 0
11 0 0
1 12 0
18 12 0
10 14 0
16 15 0
9 7 0
13 6 0
10 18 0
