width 20
height 20
@@@@@.@.@@@@@..@@@@@
@@@@.....@@@..@.@@@@
@@@@@.@.@.@.@.@.@@@@
@@@@..@...@......@@@
@@@@@..@@...@@.@.@@@
@@@@@.@@..@@.@@...@@
@@@@@@@@@......@.@@@
@@@@@@@@@.@.@@@@@@.@
@@@@@@@@@@..@..@@@..
@@@@@@@@@@@...@.@.@.
@@@@@@@@@@@.@.......
@@@@@@@@@@@@.@.@@@.@
@@@@@@@@@@......@...
@@@@@@@@@..@@@.@@@.@
@@@@@@@...@@.@@@@@@@
@@@@@@.@@..@..@@@@@@
@@@@@.....@@@.@@@@@@
...@.@@.@......@@@@@
.@.......@.@.@...@@@
@..@@.@@..@..@.@.@@@
9
7 3 0
7 0 0
11 9 0
8 1 1
11 6 1
7 17 1
0 17 2
17 9 2
6 15 2

0 18 0
14 17 0
16 19 0
11 19 1
9 19 1
13 10 1
8 18 2
5 0 2
17 10 2
