width 20
height 20
....................
....................
...@.........@.@....
.........@.@........
..........@.....@...
@.......@..........@
...@..@........@...@
..........@.........
........@....@...@..
....@...............
.....@......@.@.....
........@.@.........
........@..@....@...
......@@..@.........
....................
.............@......
.@.................@
......@....@.@..@..@
..........@........@
..@.................
9
16 14 0
10 8 0
14 4 0
10 0 0
13 16 0
14 8 0
11 5 0
18 12 0
3 8 0

15 8 0
10 8 0
6 7 0
11 1 0
18 16 0
0 15 0
5 1 0
0 1 0
3 8 0
