width 20
height 20
..........@@@@......
...@................
....................
............@.@.....
....@......@........
.@....@.............
...............@....
.@...@.@...@.....@..
.........@........@.
....................
....................
..@.......@.@.@.....
....@...........@...
.@.....@............
....................
...@....@.@.@.......
..@...@.............
...............@..@.
...........@......@@
@................@@@
9
13 1 0
2 19 0
2 17 0
16 6 0
0 11 0
8 7 0
10 13 0
12 1 0
19 14 0

0 17 0
16 17 0
14 16 0
10 6 0
14 14 0
2 4 0
12 10 0
17 5 0
8 0 0
