width 20
height 20
.....@@....@........
........@......@....
..@.................
......@..@....@.....
....................
.................@..
.....@.@...........@
.....@..............
.@..@......@........
.....@...@..........
....................
.@.@......@.........
.................@..
......@....@........
......@........@.@..
......@.............
..@.....@........@..
...............@....
............@.......
@...................
9
16 2 0
7 17 0
10 10 0
11 17 0
0 8 0
15 15 0
2 10 0
11 16 0
2 0 0

2 17 0
15 18 0
18 18 0
10 0 0
15 6 0
13 4 0
2 12 0
19 9 0
18 15 0
