width 20
height 20
..........@.........
.....@..........@...
.....@@........@....
....................
.....@.........@....
......@.......@.....
....................
............@.......
...................@
.....@@@@@@.........
.....@@.............
...@...........@....
................@...
.....@.....@........
..........@........@
...@...@.....@......
.........@..........
...@....@........@..
.............@......
....................
8
13 13 0
7 1 0
5 19 0
0 0 1
13 16 1
4 5 1
16 8 2
5 11 2

1 14 0
14 19 0
17 3 0
2 6 1
16 0 1
16 17 1
16 9 2
2 4 2
