width 20
height 20
.............@......
.................@..
..@.................
@......@.@.....@....
@.........@......@..
..@.@...............
...........@@.......
.......@.....@......
...@...........@....
....@...............
................@...
...@................
.........@..........
.....@..........@...
...........@........
.@....@.............
....@...............
...@......@.........
@...................
@...@....@@.........
6
3 2 0
2 10 0
12 3 1
9 7 1
4 7 2
8 4 2

0 12 0
2 7 0
13 17 1
12 17 1
19 6 2
9 10 2
