width 20
height 20
@@@@.@@@@@@@@@@@@@@@
@@@@..@@@@@@@@@@@@@.
@@@..@@@@@@@@@@@@.@.
@@@@..@@@@@@@@@@@...
@@@..@.@@@@@@@@...@@
@@@@....@@@@@@.@.@@.
@@@@@.@...@@.@......
@@@@..@.@.@....@.@@@
@@@@@.@..@.@.@@.@@@@
@@@..@.@........@@@@
@@@@.....@.@.@@.@@@@
@@@@@.@.@...@@@.@@@@
@@@@..@.@@@...@..@@@
@@@..@.@@@.@@@@@.@@.
@@@.@......@.@.@....
@@@@..@.@@.....@.@@@
@@@@@..@@@@@.@......
@@@@@@@@@@@@@@@@.@.@
@@@@@@@@@@@@@@@@@...
@@@@@@@@@@@@@@@@@@.@
7
11 15 0
6 5 0
7 11 0
7 14 1
12 14 1
14 6 2
16 12 2

12 9 0
7 10 0
10 15 0
11 15 1
14 9 1
4 15 2
18 18 2
