width 20
height 20
@..@.@@@...@@@.@@@@@
..@.....@.@.@..@.@@@
@..@@.@@@.....@...@@
..@....@@@@.@...@@@@
.@@@@.@@@..@@@@.@..@
..@....@..@.@.....@.
.@.@@.@.@.@...@.@...
............@.@@.@@@
.@.@@@.@@.@.@@.....@
..@.@....@.....@.@@.
@@....@@.@@.@.@@@@@.
@@@.@@@.@@@.@@.@.@..
@@@.@.......@......@
@@@.@.@@@.@...@.@.@@
@@.@..@.@@@.@@@@...@
.@.@.@@..@...@@@@.@@
........@@@@..@@...@
@@.@.@@.@@@.@.@.@.@@
@...@@.@@.......@..@
@@.@......@@.@@..@..
7
3 12 0
7 12 0
11 5 0
13 9 1
9 12 1
19 11 2
13 2 2

5 6 0
10 0 0
11 10 0
9 8 1
11 5 1
5 7 2
13 12 2
