width 20
height 20
@@@@@@@@@@.@....@...
@.@@@@@@@....@@..@.@
......@@@@.@...@@...
.@.@.@.@@@.@.@....@@
.@@.....@...@@@.@..@
...@@@.@.@@.@.@.@.@.
.@@@@@....@@...@....
.@.@.@@@@..@@.@.@@@.
.......@@@..........
.@.@.@@.@@@.@.@.@.@.
@@@.......@@@..@@@..
@@@@.@.@@@@.@.@.@..@
@@@@@....@...@@.@@.@
@@@@@@.@..@.@.@.....
@@@@@@@..@......@.@.
@@@@@@@@.@@.@.@.@@@.
@@@@@@....@@.@...@@.
@@@@@@@.@@....@.@@@@
@@@@@@@@@@@.@...@@@@
@@@@@@@@@@@@..@@@@@@
2
17 14 0
17 11 0

10 3 0
9 1 0
