width 20
height 20
@@...........@@@@@@@
...............@@@@@
...@....@.@.....@@@@
.@..@@........@@@@@@
....@...@.....@@@@@@
...................@
......@..........@..
.......@..@...@...@.
....................
@........@..........
@..........@....@..@
.....@.........@....
..........@@........
........@.@@@......@
@...@.....@.........
@...........@.......
@...@...............
@.......@...........
@......@......@..@..
@....@..............
14
9 11 0
14 16 0
9 14 0
5 1 0
3 13 0
3 0 0
16 11 0
5 5 0
6 17 0
15 5 0
16 16 0
19 12 0
7 11 0
10 16 0

7 14 0
15 10 0
2 1 0
8 14 0
11 3 0
4 1 0
14 11 0
1 14 0
18 18 0
4 6 0
1 17 0
13 1 0
12 18 0
7 3 0
