width 20
height 20
@@....@@@@@@@@@@@@@@
@@@@.@@@@@@@@@@@@@@@
@@.@..@@@..@@@@@@@@@
@@...@.@.@.@@@@@.@@@
..@@.....@.@@@.@..@.
@.@..@.@.........@..
...@..@..@.@@@.@@@.@
.@.@.@@@@@@@.....@.@
@.....@@@@.@.@.@....
@.@.@..@@...@@@@.@.@
@@@@..@@@@.@@@..@...
.@@@.@@@@......@@@.@
....@@@@@@.@.@..@...
.@.@@@..@..@.@@.@@@.
..@@@..@@@@.@.......
.@...@..@.@.@@.@.@@.
..@@.@.@@.......@@@@
.@.....@..@@@@.@@@@@
...@.@@.@.@@@@@@@@@@
.@@.........@@@@@@@@
7
0 12 0
13 11 0
9 9 0
19 4 1
17 4 1
14 10 2
8 3 2

14 5 0
10 3 0
14 17 0
2 12 1
14 6 1
5 14 2
19 5 2
