width 20
height 20
@@.......@@...@@@@.@
@..@@.@.@.@@.@.@@@.@
.@@@@@.............@
...@.@.@.@.@.@@@.@..
.@.....@.@..@@@@@.@.
..@@.@.@..@..@.@....
.@....@..@..@@.@.@.@
.@.@@..@..@@.....@.@
.@@.@.@@.@@.@.@.@.@.
@.....@@@...@.@.....
@@.@@@..@@@..@@.@.@.
@@@@.@@.@@.@.@.@@@..
@...............@.@.
.@@@.@.@.@.@.@.@....
......@.@@@@@..@.@.@
@.@@.@@.@@@@@@....@@
@@@@....@@@@.@.@.@@@
@@@..@@@@@@@.@..@@@@
@@@@.@@@@@.....@@@@@
@@@..@@@@@.@.@@@@@@@
7
10 12 0
16 2 0
8 2 0
12 5 1
19 13 1
4 9 2
9 5 2

5 12 0
18 1 0
15 9 0
14 16 1
14 12 1
3 14 2
18 7 2
