width 20
height 20
@@@@@@@@@@@@@@@@@@@@
@.@@@@@@@@@@@@@.@@@@
.....@@@@@@@@@..@@@.
.@.@..@.@@@@@@.@....
@.@..@...@@@@....@.@
...@..@.@@@@.@.@.@.@
.@@.@....@....@..@@.
......@@..@.@..@....
.@.@.@..@@.@.@...@.@
.@@....@.......@@@.@
.@@@@@..@.@@@.@@@@@.
.....@.@@@@@@..@@...
@.@@.@.@...@..@@.@.@
....@.@.@.@.@.......
@.@...........@@.@.@
...@.@.@.@.@@...@...
@.@.@.@.@@...@.@@@.@
@...@.....@.@@.@@...
..@...@.@.@...@@@@.@
@..@.@@@@@@.@..@@@..
10
13 19 0
4 9 0
16 5 0
14 9 0
3 18 0
8 6 0
5 18 0
18 5 0
6 11 0
0 5 0

3 2 0
2 11 0
6 11 0
1 5 0
6 10 0
10 6 0
1 18 0
13 6 0
4 15 0
11 19 0
