width 20
height 20
...@@@@@@@@.@@..@@..
.@..@@@@.@....@.@.@.
@..@.@....@.@.......
@@....@.@..@..@@@.@.
...@.@.@..@@.@..@.@.
@@.@.....@.....@.@.@
@...@.@.@@.@@@......
@@.@@@..@...@.@.@@.@
@..@@..@.@@@...@...@
..@.@.@..@.@.@@.@.@.
@.@.@.@@............
.....@...@.@@.@.@.@.
@@@.@@.@..@@..@@@@..
@....@@@@.@@@...@@@.
..@.@.@@.@.@.@@@.@@.
.@..................
@@@.@.@.@.@.@.@@.@.@
@@.@.@.@@@@@...@@...
..........@.@@...@.@
@.@.@@@.@......@.@@@
10
10 10 0
11 18 0
16 16 0
19 3 0
8 1 0
2 2 0
13 5 0
18 0 0
14 5 0
7 19 0

3 18 0
14 6 0
0 4 0
3 6 0
1 13 0
17 2 0
13 16 0
9 4 0
15 15 0
18 18 0
