width 20
height 20
@@@@@@@@@@@@@@@.....
@@@@@@@@@@@@@@.@.@@.
@@@@@@@@@@@@@..@@...
@@@@@@@@@@@@.@....@.
@@@@@@@@@@@....@.@@.
@@@@@@@@.@.@.@.@@...
@@@@@@@@......@@@.@@
@@@@@@@..@.@.@@....@
@@@@@@..@@@.@.@@@.@@
@@@@@.@..@.....@...@
@.@@....@..@@.@.@.@@
...@@.@..@.@.@....@@
@.@@@.@@.....@@.@.@@
...@@@...@.@..@@.@..
.@..@..@..@..@.@.@.@
.@.@.@..@..@.@......
@......@..@....@.@@.
.@.@@.@@@@@@@@..@@@.
....@..@@@@@@@@.@...
@@.@@@@@@@@@@@@.@@@.
10
19 15 0
16 3 0
11 16 0
10 13 0
16 14 0
1 10 0
15 15 0
17 10 0
15 3 0
9 10 0

1 13 0
11 6 0
0 13 0
2 18 0
18 2 0
8 13 0
6 15 0
17 18 0
11 9 0
18 5 0
