width 20
height 20
....................
....................
....@.......@...@@..
@.............@.@@..
......@..@..........
.....@.@............
.................@..
@@@............@..@.
.......@......@.....
...@......@.......@.
.................@..
.......@.....@..@..@
@...................
@@.....@.@.@........
@@@..............@..
@@......@.....@.....
@.................@.
@...@..@......@.....
@@.............@....
@@..................
11
15 2 0
6 3 0
19 14 0
5 16 0
11 19 0
19 6 0
14 9 0
10 13 0
4 13 0
3 16 0
11 9 0

14 2 0
9 17 0
15 14 0
12 3 0
15 4 0
19 9 0
14 9 0
16 14 0
1 3 0
13 17 0
1 0 0
