width 20
height 20
.........@@@........
@......@..@...@..@..
@.....@.......@.....
.........@....@.@...
.................@..
.....@..............
....................
.............@@..@..
....@..@............
.............@..@...
......@.............
....@....@..........
@.............@@@...
........@.@.........
....@...............
@.....@..@....@..@..
....@@..@...........
....@@...........@..
..........@.....@...
....................
11
9 4 0
5 11 0
5 0 0
14 5 0
3 18 0
11 5 0
9 16 0
19 15 0
19 8 0
16 0 0
17 12 0

2 18 0
12 10 0
6 8 0
17 8 0
12 15 0
5 1 0
0 10 0
5 3 0
0 9 0
3 5 0
10 15 0
