width 20
height 20
...............@@@@@
................@@..
..........@.........
....@...............
........@..@@....@..
.....@..............
...@..@..@...@......
....@.....@.........
@@@..........@..@...
...........@........
........@@.........@
...@....@......@....
..@.....@..........@
.@...@..@.@.........
........@..........@
@...@.............@@
.............@...@@@
..........@........@
..................@@
@.................@@
10
5 14 0
13 15 0
18 2 0
15 19 0
5 9 1
12 15 1
11 13 1
17 15 2
3 8 2
14 13 2

0 14 0
9 18 0
3 10 0
17 18 0
7 13 1
11 6 1
10 4 1
0 0 2
4 8 2
1 2 2
