width 20
height 20
....@@.@@...@@@.....
..@..........@......
....@.....@......@..
.@..@...............
........@....@......
....@..@.@..........
.............@......
..@.@....@..........
.................@..
....................
..............@..@..
.@...@....@.........
....@........@......
........@......@....
......@.............
................@...
..........@..@......
@@....@.@.@....@....
@@@.......@@......@.
@@................@.
10
13 8 0
14 7 0
14 17 0
1 10 0
5 9 1
12 11 1
0 8 1
14 15 2
3 10 2
14 12 2

15 10 0
14 13 0
13 10 0
5 15 0
5 9 1
1 0 1
8 11 1
13 7 2
18 0 2
15 1 2
