width 20
height 20
@@.@@@@@@@@...@.@...
@@.@.@@@...@.@...@.@
@@....@..@@@..@@....
.@.@.@.@.@.@.@.@.@.@
..@..@............@@
.@.@.@@.@.@.@.@@.@.@
......@.@@.@@@@....@
@.@@.@@@.......@@.@@
@@....@@@@.@.@@.....
@@@@.@.@.@.@....@.@.
@@@@.@.....@@.@.@@..
@@@....@.@.@@@@@.@@@
@@.@.@..@.@.@......@
@.....@.......@@.@..
@@.@@@..@.@@.@@.@@@@
@@.@@@@..@.@.@...@.@
....@@@@...@.@.@@..@
.@.@@@@@@.@....@.@..
..@@@@@@...@.@.....@
.@@@@@@@@.@@@..@@.@@
5
12 4 0
2 12 0
19 10 1
4 4 1
2 17 2

8 13 0
10 7 0
18 5 1
12 17 1
14 7 2
