width 20
height 20
@..................@
@..................@
........@..@...@....
....................
...............@....
......@.............
............@...@...
...@.............@..
....@........@......
.....@........@.@...
....................
..........@.........
....@...............
............@.......
....@.....@...@.....
....................
....@.....@.....@...
@.......@...........
....................
....................
14
4 4 0
0 10 0
9 15 0
17 14 0
12 15 0
7 0 1
12 16 1
5 17 1
5 0 1
4 2 1
6 15 2
18 4 2
7 15 2
4 13 2

8 10 0
12 18 0
8 16 0
12 19 0
3 0 0
1 18 1
19 7 1
8 6 1
17 16 1
14 11 1
2 0 2
14 1 2
19 19 2
14 5 2
