width 20
height 20
@@..................
@...................
.........@..........
...........@..@.....
@...................
....................
......@...@......@..
.....@........@.....
...........@.......@
............@..@...@
.........@......@...
....@............@..
............@.......
..........@.......@@
.......@@.........@@
....@........@......
...@.@.........@....
........@..........@
...@...............@
...................@
5
6 19 0
6 3 0
13 18 1
9 19 1
17 9 2

18 2 0
0 15 0
13 8 1
17 8 1
19 11 2
