width 20
height 20
.@@.................
..............@..@..
..@.................
.......@..@.........
.............@......
....@..@............
.....@...@.@........
....................
..@.................
........@....@...@..
...........@@.......
..@..@.....@@.......
...........@........
.................@..
..@....@...........@
........@...........
...........@@@@..@..
.......@............
....................
....................
7
10 2 0
3 13 0
10 6 0
4 15 1
8 5 1
2 1 2
18 3 2

11 13 0
14 6 0
6 12 0
3 19 1
4 19 1
18 18 2
8 3 2
