width 20
height 20
@..................@
.........@...@......
............@.......
.......@........@...
..@.@...@...........
.......@.@....@.....
...@................
.@.......@..........
.......@......@@@...
...@.......@..@@@...
...@................
........@...........
.............@......
..@......@.......@..
.........@..........
....@...............
......@@............
..........@.......@.
...........@........
....................
7
13 9 0
8 3 0
13 11 0
16 6 1
2 0 1
10 12 2
1 1 2

5 12 0
19 19 0
18 9 0
0 19 1
6 1 1
2 15 2
12 1 2
