width 20
height 20
@@@@@@@@@@@@...@.@..
@@@@@@@@@@@@@@.....@
@@@@@@@@...@..@.@@..
@@@@@@@@@@..@.@.@@.@
.@@.@@@@.@.@@...@..@
.@...@......@.@..@..
...@..@@.@.@@..@.@.@
.@..@.@..@.@@.@.@@@@
.@.@.@.@.@.@.....@@@
@.........@.@@.@..@@
@@@.@.@.@...@@@..@.@
@@@..@@@@.@@.@.@....
@.@.@@@@.......@.@.@
......@.@.@@.@.@@...
.@@.@@......@@..@.@.
...@@@@.@.@@...@.@@.
@.@@@@@@....@.@.....
....@@@@@.@.@.@.@.@.
@.@..@@@@@@@.....@..
..@@@@@@@@@@@.@.@..@
3
3 17 0
17 1 0
19 18 0

2 13 0
9 9 0
13 2 0
