width 20
height 20
...@@...@@@...@.....
@.@.@@.@.@.@.@.@.@.@
..@..............@.@
@...@.@.@@.@@.@.@.@.
..@..@..@..@.@.@@...
.@..@@.@@@........@.
..@.@.@.@.@.@@@@@@..
@@@@.......@.@@.@.@.
@@@@@@.@.@..........
@@@@.@@.@..@.@.@@.@.
@@@@......@.@.@@.@..
@@@@@@.@@.@.......@.
@@@@@@...@@@.@.@@...
@@@@@@@.@@@@@@@...@.
@@@@@@...@@@@@.@@..@
@@@@@.@.@@.@@.....@@
@@@@........@@.@@.@@
@@@@@.@.@.@@.....@..
@@@@@@.@@...@.@.@.@.
@@@@@.....@..@@.....
3
15 13 0
17 3 0
7 17 0

11 6 0
9 19 0
10 8 0
