width 20
height 20
@.@....@.....@@..@..
..@.@@@@@@.@.@@.@.@.
.@..@..@.@@.......@.
...@.@....@.@.@@@...
.@.....@.@...@.@@@@.
@..@@.@....@.@..@@.@
@@.@.@@@@.@..@.@....
.....@@@@@..@....@.@
@.@@..@@@@@..@.@@@@.
@@.@.@@@@@@.@..@.@..
.@......@@.@.@....@.
.@.@@.@.......@.@.@.
.@.@@@..@.@@.@@@....
....@@@.@.@..@@@@.@.
.@@@.@.@.@.@@@@.@.@.
...@.........@.....@
.@...@.@.@.@...@@.@@
@@@.@..@@@@..@...@@@
@@@@..@@@@@@..@.@@@@
@@@@@..@@@@@@@@@@@@@
3
0 14 0
5 5 0
17 2 0

19 12 0
0 3 0
15 11 0
