width 20
height 20
@@@@@@@.............
@@@@@@..............
@@@@@@...........@..
..@@.....@..@.......
..@@................
...........@........
................@...
.@.@...@...@......@.
.........@....@.....
...@................
..@...@.....@.......
.......@............
....................
..@...........@.....
.........@......@...
....................
..@..@.....@..@.....
..........@....@....
...................@
.....@.....@@...@...
4
9 1 0
1 4 0
8 19 1
1 8 2

17 14 0
12 7 0
8 18 1
14 11 2
