width 20
height 20
....................
...........@..@.....
................@...
...@..@.............
..........@.@.......
.@..............@.@.
...@...@............
.....@..............
....................
...@....@.......@...
...........@.@.@....
....................
.......@....@...@...
......@....@........
.........@....@.@.@.
@....@..@...........
..............@.....
........@..........@
.@........@.........
....................
3
7 1 0
11 8 0
2 16 0

17 7 0
3 18 0
9 8 0
