width 20
height 20
@@.@.@@.@@@@@@@.@@.@
@........@@@@@......
@@@.@.@.@@@@@.@.@.@.
@.@@@@..@@@@.....@..
....@.@.@.@.@.@.@@@.
@.@.......@....@@@@.
@@..@@@.@@..@@..@@@@
.@.@.@.@.@.@@.@@.@.@
.....@...........@.@
@@.@...@.@.@@@.@.@..
.@@@.@@...@@@@@@@..@
..@@@@..@@.@@....@.@
.@.@@.@.@...@.@@...@
.........@.@@@.@.@.@
.@@@@.@.@@.@......@@
...@@@.......@.@.@@@
.@@.@.@@.@.@.@.@@@@@
.@@.@.@.@@.@@...@@.@
.@@...@......@.@.@.@
@@@@@...@@.@@.......
1
5 16 0

15 11 0
