width 20
height 20
@..@@@.......@@@@.@.
@.@.@..@.@.@..@@....
.....@..@.@@.@..@.@.
@.@.@.@...@.@.@....@
.@......@.......@.@.
.@@.@.@.@.@@.@.@@.@.
....@..@...@@.@@....
.@@.@.@@@.@@..@@@.@.
..@.@.@@.@@.@..@@@..
@..@@.........@.@.@.
@@@...@.@.@.@@......
@@@.@..@.@.@.@.@.@.@
@@@@.@@.........@...
@@....@@.@.@.@.@..@@
@.@@@.....@@@..@@@@@
......@.@@.@@@..@@..
@.@@@.@..@.....@...@
@@@@@@@@.@@.@@.@.@..
@@@@@@@@@@...@@.@.@.
@@@@@@@....@........
5
19 7 0
17 12 0
18 19 0
8 14 0
18 17 0

4 13 0
8 13 0
10 12 0
13 14 0
7 9 0
