width 20
height 20
@@....@..@@.........
@@..................
.....@.......@......
....................
....................
...@................
.........@..@.....@.
....@...@......@....
.....@..............
............@.......
.......@.......@...@
...........@........
....................
....@.....@..@......
...........@........
.....@.@........@...
.@.............@.@..
....................
....................
...............@....
18
14 1 0
19 13 0
5 6 0
1 8 0
8 5 0
19 6 0
7 7 0
16 1 0
0 19 0
18 7 0
5 11 0
19 11 0
9 4 0
19 0 0
15 0 0
8 6 0
4 6 0
19 19 0

19 2 0
8 2 0
19 17 0
19 6 0
9 16 0
18 8 0
16 19 0
4 18 0
5 16 0
0 17 0
12 1 0
17 7 0
4 10 0
16 8 0
2 13 0
7 11 0
19 15 0
1 2 0
