width 20
height 20
...........@@@......
...........@@@......
...........@@@....@.
..@.@........@......
..............@.....
.@.......@.........@
....@.............@@
..............@...@@
...@....@@.........@
@......@@@....@.....
................@...
.................@..
.@....@......@..@...
.......@..@@........
..........@@......@.
.@..@.....@.........
...........@........
....................
.@..............@...
@@@@@@@.............
18
11 19 0
11 11 0
5 10 0
1 1 0
17 4 0
2 12 0
13 13 0
10 7 0
1 6 0
11 10 0
2 5 0
14 18 0
7 3 0
13 10 0
3 18 0
8 16 0
1 2 0
5 8 0

3 2 0
1 1 0
14 16 0
17 4 0
16 2 0
3 12 0
9 19 0
8 14 0
3 11 0
1 8 0
1 6 0
16 3 0
8 3 0
4 7 0
11 12 0
9 13 0
11 7 0
16 19 0
