width 20
height 20
@@@@...@.@@@@@@@@@@@
@.@.@@.....@@@@@@@@@
.......@@@@@@@@@@@@@
@.@.@@.@.@@@@@@@@@@@
..@.@.....@@@.@.@@@@
@..@..@@.@@...@.@@@@
@@@@.@.@..@.@.......
@@@@....@@@..@@.@.@@
@@@@@@.@.@..@@@@...@
@@@@@......@@.@@@.@@
@@@@@@@@.@@........@
@@.@@.@.@@@@.@@@@.@.
@@.......@.@....@...
@@.@.@@@.....@@@@.@@
@.@..@@@@@@.@@@@@@@@
....@@.@@@@@@@@@@@@@
@.@.....@@@@@@@@@@@@
...@.@.@@@@@@@@@@@@@
@.@@@@..@@@@@@@@@@@@
@@@@@@.@@@@@@@@@@@@@
2
11 10 0
6 0 1

1 5 0
18 8 1
