width 20
height 20
@@@@@@@@@@..@...@@@@
@@@@@@@@@..@@.@.@@@@
@@@@@@@..@....@@..@@
@@@@@@@.@@.@.@@@@..@
@@@@@@....@....@..@@
@@@@@@.@@.@@.@.@@.@@
@@@@.@.@.@.@@......@
@@@@..........@@.@.@
@@@@@.@.@@.@.@@@@..@
@@@@@@...@@@@@@..@..
@@.@@.@.@....@..@@@@
..........@.@@@.@@@@
@.@.@.@.@.@..@@.@@.@
@@...@@@...@@.......
@.@.@@@.@@..@@.@.@.@
.....@.....@@.@...@@
.@.@@.@.@.@@...@@.@@
.@@......@@.@.@.@.@@
...@@.@.@..........@
.@@@@@....@.@@.@@.@@
2
11 7 0
7 17 1

15 12 0
11 10 1
