width 20
height 20
@@@@@@@@@@@@@@@@@@@@
@@@@@@@@@@@@@@@@@@@@
@@@@@@@@@@@@@@@@@@@@
@@@@@@@@@@@@@@@@@@@@
@@@@@@@@@@@@@@@@@@@@
@@@@@@@@@@@@@@@@@@@@
@@@@@@@@@@@@@@@@@@@@
@@@@@@@@@@@@@@@@@@@@
@@@@@@@@@@@...@@@@@.
.@@@@@@@@@@.@..@@@..
.@@@@@@@@@..@.@@@..@
..@@@@.@...@@..@..@.
.@@@@....@@@@.@.@.@.
.@...@.@@@@.@...@.@.
..@@....@@....@@@...
.@.@.@.@@@@.@.@...@@
.....@..@@.@@.@@@.@@
@.@@..@......@.@....
....@.@@@.@@....@.@@
@.@@@@@@@@@@.@@...@@
4
13 12 0
5 18 0
1 14 1
13 18 2

8 11 0
0 11 0
8 17 1
13 18 2
