width 20
height 20
@@@@@@...@@@@@@@@@@@
@@@@@@@.@.@@@@@@@@@@
@@@@@@.....@.@@@@@@@
@@@@@@@.@.@.......@@
@@@@@@@@...@.@.@.@@@
@@@@@@@@.@....@@@@@@
@@@@@@@..@@.@@@@@@@@
@@@@@@.@.@.@@@@@@@@@
@@@.@......@@@@@@@@@
@@....@@@@@@@@@@@@@@
@@@.@@.@...@@@@@@@@@
@........@@..@@@@@@@
..@.@@@@.@..@@@@@@@@
@.@@.@@....@@@@@@@@@
@.....@@@@.@@@@@@@@@
@@.@.@@@....@..@@@@@
@@@...@@.@.@@.@@@@@@
@@@@.@@@@......@@@@@
@@@@@@@@@@@@@.@@@@@@
@@@@@@@@@@@@@@@@@@@@
4
9 4 0
9 17 0
12 2 1
12 3 2

2 11 0
14 15 0
14 3 1
10 17 2
