width 20
height 20
@@@.@@..@@@@@@@@@@@@
.@...@.@@@@@@.@@@@@@
..@@...@@@@...@@@@@@
.@@.@@.@.@@.@.@@@@@@
.............@@@@@@@
.@@@.@@@.@@.@@@@@@@@
...@@.....@...@@@@@@
.@..@@@@.@..@.@@@@@@
.@.@.@...@.@...@@@@@
@@...@.@@..@@@@@@@@@
@@@.@....@.@@@@@@@@@
@@@@@@@@..@@@@@@@@@@
@@@@@@@..@@@@@@@@@@@
@@@@@@@@..@@@@@@@@@@
@@@@@@@@@..@@@@@@@@@
@@@@@@@@..@@@@@@@@@@
@@@@@@@@@@@@@@@@@@@@
@@@@@@@@@@@@@@@@@@@@
@@@@@@@@@@@@@@@@@@@@
@@@@@@@@@@@@@@@@@@@@
4
3 4 0
3 1 0
7 12 1
10 4 2

9 13 0
6 6 0
6 2 1
0 2 2
