width 40
height 40
..........@.....@@@...............@.....
........................................
...............@......................@.
.......@..........@.....@.......@...@...
....................@......@..@.........
...............@.@....................@@
........@...@.@........................@
.........@..........@.......@.@.......@@
................@....@............@.....
..@..@......@...............@...@.....@.
.........@...@...........@@.............
....@...@.......@...@.@@...........@....
......@............@.......@.@........@.
................@.....@..@..@.@.........
...@.....@..@...........@......@........
...........@................@.........@.
..@..@.......@......@..@................
..........................@...@.........
..........@.....@.............@.........
..@..................@..................
@.......@.....@..........@..@......@....
....................@...................
...........................@............
....@........@..@..@.....@..@...@..@.@@.
........@...........@..........@.....@@.
.......@...@...@..@....@..@..........@..
.............@.................@........
....@.......@................@...@......
.@...@...........@..................@...
....................@......@.@..........
........@..@...@@.............@.........
.............................@......@@@@
....@....@...............@............@@
.@.............@............@..........@
.......@...............................@
...@....@............@.@.....@..........
..............@..........@..........@...
.............@..........................
......@..............@.......@.....@....
...........@@......................@....
41
34 10 0
37 18 0
39 28 0
30 21 0
19 18 0
30 0 0
7 1 0
34 34 0
32 8 0
37 1 0
11 18 0
25 26 0
7 17 0
1 34 0
20 33 0
12 1 0
16 32 0
14 32 0
10 30 0
8 3 0
16 17 0
14 15 0
7 16 0
36 11 0
18 23 0
18 7 0
6 3 0
26 34 0
33 10 0
4 30 0
11 14 0
22 0 0
5 35 0
37 15 0
30 6 0
21 31 0
7 10 0
3 15 0
34 35 0
21 28 0
22 19 0

19 19 0
31 10 0
19 11 0
5 35 0
38 38 0
3 36 0
18 37 0
18 24 0
2 33 0
29 13 0
39 1 0
9 19 0
0 21 0
6 22 0
38 25 0
12 19 0
17 34 0
37 18 0
36 1 0
35 25 0
17 23 0
35 37 0
39 37 0
2 34 0
23 10 0
37 39 0
6 4 0
2 20 0
10 36 0
37 0 0
22 36 0
13 9 0
39 38 0
6 21 0
1 27 0
39 2 0
35 36 0
3 16 0
8 1 0
6 37 0
5 1 0
