width 20
height 20
....................
....@.@.....@.......
...................@
...@...@.@..@......@
...................@
.@............@...@.
........@...........
.............@......
....................
............@.......
........@...........
@.........@.........
@@.......@......@...
......@.............
..................@.
.......@...@........
...@....@.@..@......
.......@..........@@
..................@@
...@.............@@@
7
7 10 0
3 15 0
15 19 0
9 9 1
13 17 1
6 11 2
6 6 2

0 3 0
11 17 0
2 1 0
12 17 1
0 1 1
16 4 2
14 7 2
