width 20
height 20
@@@@@@@@@.@@.@.@@@@.
.@.@.........@..@@@.
....@@.@@.@.@@@.@@..
@.@.@.@..@...@..@.@.
@.@.....@.@.@.@.....
..@@.@@.........@@.@
@.@@@..@@.@.@.@.@@@@
@.@@.@....@@@@@.@@@@
.....@@@.@.@@@..@@@@
@.@.@@@..@..@@@.@@@@
@.@.@.@@...@@@..@@@@
...@...@.@@.@.@.@@@@
@@.@.@@@@@.......@@@
@@@@.@@@@@@@.@@.@.@@
@.....@@@@.@@@.....@
@@@@.@@@@..@.@@.@.@.
@@...@@@@.@@....@...
@@@.@.@@.....@@..@.@
@@.......@@@..@@.@@@
@@@.@.@@..@..@@@...@
7
10 8 0
8 10 0
14 12 0
9 6 0
4 8 0
19 1 0
3 14 0

8 19 0
8 10 0
14 12 0
4 11 0
15 11 0
15 17 0
1 8 0
