width 20
height 20
@@@@@@@@@.@@@@@...@@
@@@@@@@@@...@@@.@@.@
@@@@@@@@@.@@.@......
@@@@@@@@.......@@@.@
@@@@@.@.@@@@@.@@@@.@
@@@@....@@@@.@@@@...
@@@@@.@..@.@.@.@.@.@
@@@@@@..@..@........
@@@@@@@.@.@@.@.@.@.@
@@@@@.........@@@@@@
@@@@@@@.@.@@.@.@.@..
@@@@@@@..@@@.....@.@
@@@@@@@@@@@..@.@@..@
@@@@@@@.@..@@..@@@..
@@@@@@....@.@@..@..@
@@@@@@@@@....@.@.@.@
@@@@@@.@.@@@.......@
@@@@@........@.@.@@@
@@@@@@.@.@.@.@..@@@@
@@@@@@@@..@..@.@@@@@
7
7 8 0
15 0 0
9 3 0
14 8 0
16 0 0
14 19 0
9 8 0

18 7 0
17 2 0
16 7 0
12 18 0
15 7 0
9 17 0
10 18 0
