width 20
height 20
............@..@....
...............@....
..@......@..........
....................
...@............@...
.............@......
....................
....@...@.@.........
.............@..@...
.......@......@.....
@....@..........@...
@@.....@..@.......@.
@@......@.....@.....
@@.@...@........@...
.............@......
.....@..@...@.......
...@.@..............
..@......@.@..@.....
............@.......
....................
10
8 11 0
12 14 0
14 5 0
14 19 0
4 4 0
0 1 0
14 8 0
19 2 0
18 14 0
18 16 0

4 17 0
15 12 0
14 5 0
0 0 0
15 19 0
1 1 0
8 19 0
11 8 0
16 11 0
15 18 0
