width 20
height 20
@@@@@@@.@.@@@@....@.
@@@.......@.@.@.@...
@@@@.@@.@......@@.@.
@@@@@@...@.@.@@@@@@.
@@@@@.@.@.@@@@@@@@..
@@.@..@....@@@@@@@@.
.....@.@.@.@@@@@@@@.
@.@@.....@..@@@@.@..
@.@@.@@.@..@@@@....@
.@@..@@@.@.@.@@@@.@@
.@.@..@........@...@
.....@.@.@@.@.@@@@..
@@.@.@...@@@.@.@...@
....@@@@..@@.....@..
.@.@@@@..@...@@@.@.@
.@@.@@@@...@..@..@..
......@@@@..@@@@@..@
.@@.@.@@@@@..@@@@@..
...@..@@@@..@.@@...@
.@@..@@@@@@...@@.@..
6
4 6 0
11 14 0
18 19 0
10 8 0
3 15 0
2 14 0

1 6 0
3 17 0
10 6 0
10 8 0
7 8 0
17 0 0
