width 40
height 40
@...........@@..@.......@...............
....................@...@......@.......@
..............@...@....................@
...............@........................
.....@...@..@....@@..........@......@...
.................@..@..@.............@..
...........@...@...........@...........@
............@.........@.@...............
.....@....@........@..........@.........
.@..@@...................@..@...........
......@...........@...............@.....
...@...................@................
..@.....@.@...@.....................@...
...@..@.................@....@..........
................@......@........@.......
..@.............@.....@.................
.@.....@..@.............................
......@.@........@.@..............@.@...
.................................@......
..............@....@..@...@.........@..@
....@....@..................@..@.@.....@
......@.........@..@..............@....@
.....@....@...............@........@....
................................@@......
.........@.@........@.@...@.............
................@................@......
.............@......@.......@...........
.........@.........................@..@.
...............@..@..@..@...............
....@......@..@........@..........@.....
@....@...........@..@......@..@.......@.
...@..@.................@...............
...@....................@.............@.
..@@......@.@..@.............@..........
@.....@.@...........@.@...........@...@.
@......@.....@@.........................
....@....@................@.............
...@...@......@....@@....@..@...@.......
......@........@..@@@..........@........
@@..................@...................
2
36 13 0
8 1 0

13 25 0
0 23 0
