width 20
height 20
@@@@@@@@@@@@@@@@@@@@
@@@@@@@@@@@@@@@@@@@@
@@@@@@@.@@@@@@@@@@@@
@@@@@@@.@@@@@@@@@@@@
@@@@@@..@@@@@@.@@@@@
@@@@@@@...@@@@.@@@@@
@@@@@@..@.@@@..@@@@@
@@@@@@.@@.@@.@..@@@@
@@@@@@@.@.@@.@.@@@@@
@@@@...........@@@@@
@@@@@@.@@@.@.@.@@@@@
@@@@@@@....@@@@@@@@@
@@.@.@.@.@.@.@@@@@@@
@.........@...@@@@@@
@@.@@@.@.@..@..@@@@@
@@@@@@@..@.@.@@@@@@@
@@@@@@@@......@@@@@@
@@@@@@@@@@.@@@@@@@@@
@@@@@@@@@@@@@@@@@@@@
@@@@@@@@@@@@@@@@@@@@
25
6 4 0
7 13 0
7 6 0
10 10 0
3 13 0
13 14 0
12 16 0
12 12 0
12 7 0
2 12 1
12 8 1
9 13 1
8 11 1
8 14 1
7 15 1
8 5 1
6 13 1
13 13 2
12 9 2
10 16 2
13 16 2
14 8 2
8 12 2
10 17 2
10 11 2

12 12 0
8 12 0
8 9 0
11 9 0
5 9 0
10 11 0
10 9 0
8 13 0
14 6 0
3 13 1
12 13 1
7 6 1
8 5 1
10 12 1
14 4 1
11 14 1
13 16 1
15 7 2
12 16 2
6 9 2
6 12 2
7 11 2
6 4 2
8 15 2
9 16 2
