width 20
height 20
.........@..........
........@@..........
....................
.....@..............
..@.@....@..........
........@......@....
.......@............
............@.......
......@.........@...
.......@..@.........
...@.......@........
...............@....
.@....@...........@.
..............@.....
.............@......
.........@..........
.@.@................
.@@..@..........@...
@@@.................
@@@@@@..............
14
10 11 0
3 12 0
0 13 0
15 17 0
11 7 0
8 7 1
6 16 1
11 4 1
12 16 1
5 10 1
7 14 2
2 6 2
11 16 2
9 19 2

3 18 0
7 14 0
15 0 0
2 0 0
13 7 0
5 7 1
19 5 1
12 1 1
2 5 1
17 4 1
14 1 2
18 17 2
8 6 2
5 4 2
