width 40
height 40
....@.............@.....................
..........@..........@......@...........
....@..........@...@.....@........@.....
...@.........@........@......@..@....@..
...............@............@...........
.......@..........@.@.......@...........
.@@.......@.................@...........
.........@..................@.......@...
................@.@.@.........@.@.......
.....@........@...........@.............
...@....@.........................@.....
..@.@..@............@@..@@@....@........
.........@......@.......@@@........@..@.
..@.....@.@....................@........
..............@.....................@...
...@.....@.....@.....@..@........@......
....@...................................
..................@...@@@...@@..........
.@............@.......@@@@..............
........@...@..................@........
.....@..................................
..........................@........@....
........@............@..@......@......@.
.....@......@.@.........................
.....................@...........@...@..
..@......@.............@..@..@........@.
..................@...@.................
.............@.........@..........@.....
...@.@..........@.............@.........
..........@.....@@......@..@......@.....
..@........@...@.................@...@..
...@...........@........................
.........@.@....................@.......
......@............@...............@....
.................@.......@........@..@..
@..........@...@...@.........@........@.
..........@...............@.............
...............................@.@.@.@..
......@.........@.@....@@@@.............
................@...@@@@@@@.............
15
21 17 0
18 1 0
22 35 0
12 17 0
1 7 0
32 5 0
32 7 0
37 25 0
19 9 0
11 29 0
12 32 0
25 26 0
12 28 0
38 13 0
11 23 0

31 34 0
0 21 0
25 36 0
5 39 0
27 32 0
29 19 0
3 17 0
34 33 0
22 10 0
38 1 0
29 10 0
2 35 0
18 18 0
2 38 0
0 28 0
