width 20
height 20
@@.@@.@@@...@@@...@@
@.........@@.@@@@...
..@@.@@.@.....@@@.@@
@...@@@@@@@.@..@...@
.@.@@@@@@@@@..@@@.@@
...@@@@@@@@.@..@...@
.@..@@@@@@....@..@@@
.@@...@@@@@.@.@.@.@@
.@.@@@@@@....@.....@
@@.....@@.@.@..@@.@.
@@.@.@.@@.@@@@@.....
@...@.@.@.@.@.@.@.@@
..@..............@@.
.@..@.@.@.@@@@@@....
..@..@...@@@.@.@.@@.
@@..@@@.@@......@...
...@@.@.@.@.@.@...@.
.@.....@....@@@@@..@
..@.@@..@.@.....@.@@
.@@.@..@...@.@@.@@@@
11
11 7 0
13 7 0
7 18 0
0 16 0
11 5 1
12 4 1
1 12 1
19 10 1
1 14 2
6 1 2
4 14 2

15 18 0
15 11 0
0 4 0
2 15 0
11 6 1
15 15 1
6 18 1
17 10 1
7 11 2
3 12 2
19 12 2
