width 20
height 20
....................
...@@....@......@@..
....@......@.@..@...
....................
..................@.
....@...............
........@.....@.@...
....................
........@...........
.....@........@.@...
...........@........
..@...@..@....@.....
....@............@..
.@.........@........
....@.@.........@@..
.......@..@.@...@@@.
.............@...@..
.....@....@.........
@@@.@.........@.....
@@..................
5
16 10 0
15 15 0
5 6 0
0 12 0
9 4 0

6 0 0
11 17 0
6 3 0
11 5 0
12 5 0
