width 20
height 20
....................
.....@.......@......
.@...............@..
..@......@....@....@
.......@.........@..
...........@.@......
....@...@...........
.........@..@...@...
..@..........@......
@..@........@.....@@
@.....@...@.....@..@
@..@........@.......
@@.............@....
.....@..............
......@..@..@.@.....
...@.......@....@...
..@...@.............
....................
......@...........@.
............@@@.....
5
19 0 0
2 0 0
9 15 0
9 17 0
14 17 0

8 2 0
9 4 0
0 0 0
2 1 0
11 12 0
