width 20
height 20
@@@@@@@@@@@@@.@.@@@@
@@@@@@@@@@@@.....@@@
..@@@@@@@@@@@@@@..@@
@..@@@@@@@@@@@...@@@
..@@@@.@@@@@@.@.@.@@
@..@@@..@@@@..@.....
..@....@.@@.@.@@@.@.
@...@.@............@
@@@..@.@.@.@.@.@@@..
@...@@.@..@.@@@..@.@
.@.@.....@...@.@....
....@.@.@.@.@....@.@
.@.@...@.....@.@@.@.
..@@@.@@.@@.@.......
@..@.@...@....@@.@@.
@.@@..@.@.@.@..@@...
.....@.@..@.@.@@.@.@
.@.@.....@.@.@......
..@..@@@......@.@.@.
.@@.@....@.@@....@@.
7
14 10 0
18 9 0
6 14 0
5 19 1
1 2 1
19 5 2
16 19 2

14 10 0
13 18 0
13 15 0
5 13 1
19 12 1
1 15 2
1 3 2
