width 20
height 20
..@........@....@@@@
.@..@@.@@@.@.@.@@@@@
..@.@.@@..@..@@.@@@@
.@....@@@.@@....@@@@
..@.@..@..@..@.@.@@@
@..@..@.@.@.@..@.@.@
..@.@......@.@......
@.@..@@.@@...@.@.@@@
....@.@@..@.@.@.....
@.@...@.@......@.@.@
...@@.....@.@.@..@..
@.@.@.@.@@.@.@@@.@.@
.....@.@.@....@@..@.
@@@.@......@.@.@.@@.
.@....@@.@.@.@......
...@@...@.@....@.@.@
.@...@@....@.@.@@@@.
@..@..@.@.@@..@.....
@.@..@@.@@...@.@.@.@
@@@@...@@@@@......@@
7
19 14 0
8 2 0
6 10 0
6 19 1
16 11 1
10 18 2
1 5 2

11 8 0
2 15 0
16 6 0
5 10 1
9 3 1
9 9 2
8 13 2
