width 20
height 20
@@.@@@@@........@@@@
...@.@@@@@.@.@@..@@@
.@.......@.@.@..@@@@
..@.@@.@@@..@@@@@@@@
.@@@@@..@..@@@@@@@@@
@@@@@..@.@.@@...@@@@
@@@@@@.@.@..@.@.@@@@
@@@@@....@@...@.@.@@
@@@@@@.@....@.@.....
@@@@@@@@@.@.@.@.@.@.
@@@@@@@@@@.@@@@@@@..
@@@@@@@@.@..@@....@.
@@@@.@@@...@..@@.@@.
@@@@.@@..@...@.@....
@@@....@@.@@.@...@.@
@@@@.@@.@......@..@@
@@@.......@.@@.@@...
@@..@.@.@..@.....@@.
@@.@@.@..@@@@.@.@@..
...@@.@@@@@@..@@...@
10
4 15 0
6 7 0
19 11 0
13 6 0
19 13 1
9 8 1
19 12 1
8 6 2
2 0 2
12 12 2

11 8 0
5 17 0
1 3 0
9 9 0
9 17 1
17 13 1
0 4 1
18 18 2
4 15 2
14 5 2
