width 20
height 20
............@.....@@
.......@.......@....
....................
..@..@..............
...........@........
................@...
........@.@...@.....
............@.......
@................@@@
@......@...@..@..@@@
.....@..............
............@.......
......@.............
.........@..........
.......@...@....@.@.
.................@..
...@................
........@..@........
....................
..............@@@...
10
1 7 0
16 1 0
10 16 0
9 17 0
19 12 0
10 14 0
0 11 0
1 17 0
13 5 0
19 11 0

3 7 0
15 3 0
17 5 0
6 17 0
5 2 0
16 0 0
7 12 0
18 4 0
0 19 0
6 0 0
