width 20
height 20
...@.........@......
....................
......@.............
..@.@....@..........
.......@....@...@...
.........@.@..@.....
@@..................
@............@......
...@.....@.@........
..@............@....
......@.............
....@...............
.................@..
..@.@...............
..@...@...@.........
..@.................
.....@.@............
.............@......
..........@........@
...@@..............@
10
15 12 0
18 8 0
11 7 0
8 10 0
12 14 0
6 4 0
8 14 0
10 9 0
19 13 0
9 4 0

8 17 0
5 4 0
11 7 0
7 18 0
10 2 0
6 4 0
3 6 0
11 4 0
2 0 0
19 14 0
