width 20
height 20
........@@@@@@......
.@....@.............
..........@......@..
.@.....@...........@
..............@....@
....................
.............@......
...........@........
........@.......@...
....@.@.............
....................
....................
....................
......@........@....
.........@.@........
....@.........@..@..
......@......@@.....
..@........@........
..@........@........
@@@.................
5
1 5 0
17 10 0
10 10 0
2 6 0
13 12 0

1 7 0
0 13 0
3 1 0
10 18 0
0 10 0
