width 20
height 20
....................
........@...........
....@.......@.......
.........@.@........
.......@..@.@.......
................@...
..@.......@........@
.........@.@........
...............@....
...@................
....................
....................
..@........@........
...@...........@....
....................
.........@.....@....
.@....@.....@.......
....@......@........
....................
....................
12
17 11 0
2 17 0
10 10 1
1 0 1
16 9 2
16 16 2
7 12 3
15 16 3
16 11 4
7 19 4
19 14 5
10 2 5

2 9 0
19 10 0
2 17 1
15 19 1
14 12 2
3 5 2
19 13 3
5 3 3
13 0 4
7 18 4
1 0 5
13 9 5
