width 20
height 20
....@...........@@@@
@..............@@@@@
...............@@@@@
@........@..........
@......@.......@....
....@.@.............
................@.@.
...........@.....@..
...@.........@......
........@...........
..................@.
..@...@.@....@.@....
....................
...@.@..@...@.......
.......@.....@......
....................
....................
...@........@.......
.....@..............
...........@........
2
19 4 0
19 7 1

19 8 0
0 17 1
