width 20
height 20
.@@.@.@..@@.@@@.@@@@
........@.@..@....@@
@.@.@.@.@...@.@@@.@@
@.@@@@@...@........@
@@@@@.@@.@..@.@.@@..
@@@@@....@@..@@.@@@@
.@@@.@@@@...@@@@@@@@
.....@@@@@.@@@@@@@@@
@.@@.@@@@..@@@@@@@@@
@@...@@@@@.@@@@@@@@@
@.@@.@@@@@...@@@@@@@
..@...@@@@@.@@@@@@@@
@..@.@.@.@..@@@@@@@@
..@........@@@@@@@@@
@...@.@.@.@@@@@@@@@@
@.@..@@@@.@@@@@@@@@@
@@@.@@@@....@@@@@@@@
@....@@@@@.@@@@@@@@@
@@.@.@@@@...@@@@@@@@
@@@@@@@@@@.@@@@@@@@@
15
10 12 0
6 1 0
17 3 0
11 6 0
0 6 0
4 18 1
11 1 1
8 4 1
9 8 1
10 4 1
3 13 2
8 3 2
10 6 2
13 3 2
0 11 2

7 5 0
18 3 0
19 4 0
9 15 0
4 13 0
1 3 1
10 13 1
15 0 1
11 3 1
1 15 1
9 14 2
9 13 2
8 0 2
11 12 2
3 16 2
