width 40
height 40
....................@@@@................
...................................@....
..@.........@..................@........
@................@..........@.@.........
......@............@...@.@..............
...@...@....@..@......................@.
.@........@.......@....@.......@........
.........................@.......@...@..
......@.@.....@.........................
..@..........@.......@.....@............
....@.................@.@.........@@....
............................@.@.@.....@.
............@..........................@
..@.@....@..........@....@..........@..@
@@@..........@..................@.....@@
@@@...@.........@.......................
...........@...........@............@...
.@......@......@....@...@...............
...........@.........@..................
....@..@.@.....@...............@.....@..
...@............@..........@.@@@........
......@.....@.....@.....................
..............@........@.@..@.....@@....
.........@...@..@.@.@.@....@.....@.@....
..@.@...@...@......@........@.@.@.......
...@...................@...............@
.......@........@.........@...@.........
.......@.......@........@.............@.
....@........@..@..............@..@.....
.......@..@..........@@...........@....@
.@..@.@..........@...@.....@............
..........@.............................
............@..........@.............@..
@@.......@............@.@...........@...
@@....@.............@...........@.......
.@............@..........@.@..@.........
..@...........@...@................@....
......................@..........@......
...........................@............
..@.....................................
30
20 14 0
8 19 0
29 15 0
38 24 0
14 7 0
18 2 0
17 6 0
0 28 0
3 32 0
25 16 0
19 33 1
1 20 1
9 17 1
39 10 1
29 32 1
32 6 1
14 6 1
30 33 1
7 31 1
11 26 1
37 4 2
24 11 2
33 34 2
37 23 2
35 33 2
6 16 2
23 31 2
18 0 2
30 21 2
20 19 2

33 15 0
19 31 0
19 16 0
26 13 0
12 20 0
9 7 0
38 39 0
39 1 0
32 19 0
1 37 0
7 34 1
38 0 1
37 8 1
4 39 1
13 8 1
10 27 1
15 12 1
24 18 1
30 13 1
8 25 1
0 38 2
38 24 2
0 6 2
3 0 2
32 28 2
39 39 2
0 13 2
24 25 2
1 1 2
38 25 2
