width 20
height 20
....................
.................@..
......@......@......
....................
....@.........@.....
.@.@...........@....
............@....@..
..@....@.@..........
....@.@.......@.....
.............@......
........@..@....@...
...@................
.......@.......@....
.....@..............
...@........@....@..
@...................
.......@............
@....@..............
...............@....
.....@.........@....
11
15 1 0
0 8 0
13 6 0
14 15 0
5 9 0
19 8 0
14 12 0
17 15 0
17 8 0
13 11 0
12 11 0

5 14 0
16 17 0
13 6 0
5 1 0
19 6 0
17 0 0
6 0 0
5 7 0
0 19 0
1 0 0
17 11 0
