width 65
height 81
@@@@@@@@@@@@@@@@@@@@@@@@@@@@@@@@@@@@@@@@@@@@@@@@@@@@@@@@@@@@@@@@@
@@@@@@@@@@@@@@@@@@@@@@@@@@@@@@@@@@@@@@@@@@@@@@@@@@@@@@@@@@@@@@@@@
@@@@@.@@@@@.@@@@@@@.........@@@@@@@@@@@@@@@@@@@@@@@@@@@@@@@@@@@@@
@@@@........@@@@@@..........@@@@@@@@@@@@@@@@@@@@@@@@....@@@@@@@@@
@@@@........@@@@@@@.........@@@@@@@@@@@@@@@@@@@@@@@@...@@@@@@@@@@
@@@.........@@@@@@@..........@@@@@@@@@@@@@@@@@@@@@..........@@@@@
@@@........@@@@@@@@..........@@@@@@@@@@@@@@@@@@@@@..........@@@@@
@@.........@@@@@@@@..........@@@@@@@@@@@@@@@@@@@@@..........@@@@@
@@.........@@@@@@@...........@@@@@@@...@@@@...@@@@............@@@
@@.........@@@@@@@@@.........@@@@@@@....@@@...@@@.............@@@
@@.........@@@@@@@@@..........@@@@............................@@@
@@@............@@@@@..........................................@@@
@@@............@@@@...........................................@@@
@@@............@@@@..........................................@@@@
@@.............@@@@...........@@@@@....@@@.....@@@....@@@@@@@@@@@
@@@@...........@@@@.........@@@@@@@@@@@@@@@@@@@@@@@@@@@@@@@@@@@@@
@@@@.@@@@.....@@@@@@........@@@@@@@@@@@@@@@@@@@@@@@@@@@@@@@@@@@@@
@@@@.@@@@....@@@@@@@........@@@@@@@@@@@@@@@@@@@@@@@@@@@@@@@@@@@@@
@@@@.@@@@....@@@@@...........@@@@@@@@@@@@@@@@@@@@@@@@@@@@@@@@@@@@
@@@@.@@@@....................@@@@@@@....@@@@@@@@@@@........@@@@@@
@@@@.........................@@@@@@@....@@@@@@@@@@@.....@@@@@@@@@
@@@@.........................@@@@@......@@@@@@@@@@@.....@@@@@@@@@
@@@..........@@@@@@..........@@@@@......@@@@@@@@@@@.....@@@@@@@@@
@@@..........@@@@@@..........@@@@@......@@@@@@@@@@@.....@@@@@@@@@
@@@.@@@@@@@@@@@@@@@..........@@@@@@....@@@@@@@@@@@@.....@@@@@@@@@
@@..@@@@@@@@@@@@@@@..........@@@@@@....@@@@@@@@@@@@.....@@@@@@@@@
@@..@@@@@@@@@@@@@@@...........@@@@.....@@@@@@@@@@@@.....@@@@@@@@@
@@..@@@@@@@@@@@@@@@.....................................@@@@@@@@@
@@..@@@@@@@@@@@@@@@.....................................@@@@@@@@@
@@..@@@@@@@@@@@@@@@...........................................@@@
@@@@@@@@@@@@@@@@@@@...........@@@@............................@@@
@@@@@@@@@@@@@@@@@@@...........@@@@@@@@@@@@@@@@@@@@@@@@@@@@@@@@@@@
@@@@@@@@@@@@@@@@@@@...........@@@@@@@@@@@@@@@@@@@@@@@@@@@@@@@@@@@
@@@@@@@@@@@@@@@@@@............@@@@@@@@@@@@@@@@@@@@@@@@@@@@@@@@@@@
@@@@@@@@@@@@@@@@@@............@@@@@@@@@@@@@@@@@@@@@@@@@@@@@@@@@@@
@@@@@@@@@@@@@@@@@@.................@@@@@@@@@@@@@@@@@@@@@@@@@@@@@@
@@@@@@@@@@@@@@@@@@.................@@@@@@@....@@@@@@@.@@@@@@@@@@@
@@@@@@@@@@@@@@@@@@.....................@@@.....@@@.............@@
@@@@@@@@@@@@@@@@@@@............................................@@
@@@@@@@@@@@@@@@@@@@...........................................@@@
@@@@@@@@@@@@@@@@@@@...........................................@@@
@@@@@@@@@@@@@@@@@@@...........................................@@@
@@@@@@@@@@@@@@@@@@@..........................................@@@@
@@@@@@@@@@@@@@@@@@@@..................@@@@@@@@@..............@@@@
@@@@@@@@@@@@@@@@@@@@..................@@@@@@@@@..............@@@@
@@@@@@@@@@@@@@@@@@@@..@@@@.....@@@..@@@@@@@@@@@...............@@@
@@@@@@@@@@@@@@@@@@@@@@@@@@@...@@@@@@@@@@@@@@@@@@@@@...@@@@@@@@@@@
@@@@@@@@@@@@@@@@@@@@@@@@@@@...@@@@@@@@@@@@@@@@@@@@@...@@@@@@@@@@@
@@@@@@@@@@@@@@@@@@@@@@@@@@@...@@@@@@@@@@@@@@@@@@@@@...@@@@@@@@@@@
@@@@@@@@@@@@@@@@@@@@@@@@@@@...@@@@@@@@@@@@@@@@@@@@@@..@@@@@@@@@@@
@@@@@@@@.@@@@@@@.@@@@@@@@@.....@@@@@@@@@.@@@@@@@@@@......@@@@@@@@
@@@@@@@@.@@@@@@@.@@@@@@@..........@@@@@@.@@@@@@@@@@......@@@@@@@@
@@@@@@@@..@@@@@@.@@@@@@@..........@@@@@@.@@@@@@@@@@.......@@@@@@@
@@@@..@@..@@@.@@...@@@........................@@@@@.........@@@@@
@@............................................@@@@@.........@@@@@
@@............................................@@@@@........@@@@@@
@@............................................@@@@@........@@@@@@
@@...........@@.@.............................@@@@.........@@@@@@
@@@..@@......@@@@....@@.......................@@@@...........@@@@
@@@..@@@@@..@@@@@....@@@@.........@@@@@@.@@@..@@@@..........@@@@@
@@@..@@@@@...@@@@....@@@@.........@@@@@@.@@@@.@@@@............@@@
@@@..@@@.......@@...@@@@..........@@@@@@.@@@@.@@@@.....@@@@@@.@@@
@@@.................@@@@@.....@@@@@@@@@@@@@@@@@@@@@@@@@@@@@@@@@@@
@@....................@@....@@@@@@@@@@@@@@@@@@@@@@@@@@@@@@@@@@@@@
@@@@@@@@@@@@@@..............@@@@@@@@@@@@@@@@@@@@@@@@@@@@@@@@@@@@@
@@@@@@@@@@@@@@..............@@@@@@@@@@@@@@@@@@@@@@@@@.......@@@@@
@@@@@@@@@@@@@@................@@@@...........................@@@@
@@@@@@@@@@@@@@...............................................@@@@
@@@@@@.....@@@...............................................@@@@
@@@@@@.....@@@.................................................@@
@@@@@.....@@@@................@@@@.............................@@
@@@@@.....@@@@........@@@....@@@@@.............................@@
@@@@@.....@@@@........@@@....@@@@@.............................@@
@@@@@.....@@@@........@@@@@@..@@@@.............................@@
@@@@@.....@@@@........@@@@@@..@@@@@@...........................@@
@@@@@.....@@@@........@@@@@@..@@@@@@.............................
@@@@@............@@@..@@@@@@.@@@@@@@.............................
@@@@@...........@@@@..@@@@@@@@@@@@@@...@@@@@@@@@@@@@@@@@@@.......
@@@@@...........@@@@....@@@@@@@@@@@@...@@@@@@@@@@@@@@@@@@@.....@@
@@@@@@@@@@@@@@@@@@@@@@@@@@@@@@@@@@@@@@@@@@@@@@@@@@@@@@@@@@@@@@@@@
@@@@@@@@@@@@@@@@@@@@@@@@@@@@@@@@@@@@@@@@@@@@@@@@@@@@@@@@@@@@@@@@@
17
48 38 0
5 76 0
53 54 0
20 29 0
27 66 0
52 9 0
14 54 0
59 13 0
23 54 0
2 9 0
24 26 0
34 36 0
25 55 0
6 6 0
27 68 0
42 70 0
23 29 0

39 73 0
15 71 0
52 54 0
16 19 0
26 67 0
51 11 0
7 11 0
26 25 0
60 78 0
20 16 0
56 76 0
53 6 0
32 39 0
46 75 0
45 58 0
51 75 0
28 12 0
