width 20
height 20
@@@@@........@@@@@..
@@@@..@.@.@.@@@@@..@
@@@.@..@...@.@....@.
@@....@@@@...@.@@@..
@@@@.@@@...@......@.
@@@@.@@@@.@.@.@.@.@.
@@@...@@@.@..@.@..@.
@@@@.@.@.@@@...@@...
@............@.@..@.
.@@.@@.@.@.@..@..@..
..@@@.@.@.@.@.@@..@.
.@...........@...@@@
...@@.@.@@@.@@@@.@..
.@.@.@.@.@.@.@...@.@
@..............@....
.@.@.@@@.@.@@.@@.@@.
...@@@.@@.@.@.@.@...
.@......@.....@...@.
..@@.@.@@@.@.@@.@..@
.@@@@..@@@@..@@..@..
1
16 4 0

17 10 0
