width 20
height 20
@@@@@@@@@@@@@..@.@..
@@@@@@@@@@@@..@@..@.
@@@@@@@@@@@.@.@.@...
@@@@@@@@@.........@.
@@@@@@@@@.@.@.@.@..@
@@@@@@@@@@@@.@.@..@.
@@@@@@@@@@@......@..
@@@@@@@@@@@@.@.@...@
@@@@@@@@@@@.@..@.@..
@@@@@@@@......@@@..@
@@@@@@@@.@.@@..@..@@
@@@@@@@@@@.@..@..@@@
@@@@@@@@@@@.@..@@@@@
@@@@@@@@@@@...@@@@@@
@@@@@@@@@@@@@@@@@@@@
@@@@@@@@@@@@@@@@@@@@
@@@@@@@@@@@@@@@@@@@@
@@@@@@@@@@@@@@@@@@@@
@@@@@@@@@@@@@@@@@@@@
@@@@@@@@@@@@@@@@@@@@
11
16 5 0
13 2 0
19 6 0
11 6 0
18 9 1
19 1 1
17 1 1
11 4 1
18 8 2
17 3 2
16 6 2

11 13 0
16 0 0
17 4 0
12 6 0
18 8 1
14 6 1
14 12 1
17 2 1
11 3 2
10 11 2
19 1 2
