width 20
height 20
.@@@@@@@@@@@@@@@@@@@
..@@@@@@@@@@@@@@@@@@
@..@@@@@@@@@@@@@@@@@
..@@@@@@@@@@@@@@@@@@
@.@@@@@@@@@@@@@@@@@@
@.@@@@@@@@@@@@@.@.@@
...@@@@@@@@@@@.....@
@.@@@@@@@.@@@@@.@.@@
...@@@@@..@.@@@.@...
.@..@@.@.@..@....@@.
..@@.......@@.@.@..@
.@.@@.@.@.@.@..@..@@
.@.@.@.@......@@@.@.
.........@.@.@@...@.
.@.@.@@.@@@.....@...
..@@...@@@@@.@.@@@.@
@...@.@@@@@@.@.@.@..
..@@.@@@@@..@@@....@
@.....@@@@@....@.@..
..@@@@@@@@@@.@....@@
13
17 14 0
9 11 0
8 10 0
15 6 0
6 9 0
1 18 1
6 12 1
18 17 1
15 7 1
1 8 2
9 7 2
10 9 2
15 10 2

18 8 0
1 7 0
7 13 0
19 16 0
6 9 0
2 13 1
0 1 1
15 19 1
17 12 1
8 10 2
11 17 2
11 12 2
1 3 2
