width 20
height 20
@@@@@@@@@@@@@@@@@@..
@@@@@@@@@@@@@@@@@@@.
@@@@@@@@@@@@@@@@@...
@@@@@@@@@@@@@.@@@.@.
@@@@@@@@@@@@@..@@@..
@@@@@@@@@@@@..@@@.@.
@@@@@@@@@@@@@.@.....
@@@@@@@@@@@@....@@@.
@@@.@@@@@@@@@.@.@@..
.@@..@.@@@@@@.@@@@@@
....@...@@@@..@@@@..
@.@...@..@@@.@.@@..@
@@@@@..@@@@@....@.@@
@@@@@@.@@@@@@@@.....
@@@@@...@@@@@@..@.@.
@@@@@@.@.@.@..@.@@..
@@@@@.......@....@.@
@@@@@.@.@.@...@.@@@@
@@....@..@.@@.@...@@
@@@.@.@@@@....@.@@@@
13
5 18 0
17 3 0
18 13 0
13 8 0
10 15 0
17 11 1
15 6 1
3 18 1
13 7 1
19 8 2
15 12 2
8 15 2
14 12 2

16 13 0
18 8 0
10 15 0
12 19 0
17 12 0
15 16 1
10 16 1
13 7 1
19 0 1
11 19 2
14 16 2
6 10 2
17 5 2
