width 20
height 20
..................@@
...................@
.......@...@.......@
.@.................@
...................@
...............@@@@@
..@..............@@@
...@.....@...@@...@@
..........@...@...@@
.......@...........@
....@..........@....
............@.......
....................
......@..@.@........
.....@.........@....
..............@.@...
.@...@@.@...........
.@..................
..................@@
...@.............@@@
9
2 8 0
12 7 0
1 6 0
11 18 1
11 9 1
7 1 1
8 15 2
4 15 2
1 15 2

0 10 0
0 19 0
10 7 0
3 4 1
0 3 1
10 11 1
3 11 2
10 12 2
11 1 2
