width 20
height 20
....................
....@....@..........
....................
.............@......
.........@......@...
..........@....@....
...@.@.@.........@..
....................
...@.........@..@...
.....@........@.....
........@...@.....@@
................@..@
.........@..@.@.....
....@...@...........
...@................
...................@
......@....@..@..@..
.......@............
.........@..@..@....
....@......@......@@
4
0 15 0
3 9 0
14 8 1
15 7 2

19 0 0
2 9 0
12 9 1
7 4 2
