width 20
height 20
....................
.@..................
............@.......
.....@....@.........
...@...........@...@
.......@............
.@........@.........
...............@....
..@....@..@.........
.........@.@.@......
....................
.........@....@...@.
..........@......@..
........@...........
....@..@..@..@......
..................@@
...............@..@@
..@.......@.......@@
...@.@.....@......@@
..................@@
4
16 17 0
0 6 0
11 10 1
14 14 2

15 18 0
4 9 0
14 10 1
0 1 2
