width 20
height 20
.....@....@...@.....
.@.@...@.@@@@.@.@@@.
.@@@@@..@@@...@..@@@
...@.@.@.@..@..@.@@.
.@.@.@.@..@@.@......
..@......@.@...@@@@.
.@@@.@.@.....@@@@@@@
@@@..@.@.@@@.@@@@@@@
@@@@.@@.@@@@@@@@@@@@
@@@@....@@@@@@@@@@@@
@@@@.@@.@@@@@@@@@@@@
@..@@.@..@@@@@@@@@@@
@@......@@@@@@@@@@@@
...@.@.@.@@@@@@@@@@@
@.@@..@@.@@@@@@@@@@@
@@.@.@@..@@@@@@@@@@@
@@.@.@.@..@@@@@@@@@@
@....@...@@@@@@@@@@@
@@.@...@@@@@@@@@@@@@
@...@.@@@@@@@@@@@@@@
7
6 17 0
6 16 0
14 5 0
11 6 1
2 11 1
6 9 2
7 17 2

10 3 0
17 4 0
7 11 0
4 1 1
0 1 1
13 2 2
11 3 2
