width 20
height 20
@@@@@@@@...@@@@@@.@@
@@@.@@.@@@.@@@@@...@
@@......@@.@@@@@@.@.
@@@.@@@.@@..@@@@@...
@@@@.....@.@.@@@.@.@
@.@@@.@.@........@.@
....@.@@..@@@.@@....
.@@...@.@.@@@@...@.@
@@.@@.@.@@@@@.@@.@@.
.@.@....@@@.......@.
...@.@.@.@@@@.@.@@@.
.@.@@....@@@...@.@..
.@.@.@.@..@@@.@....@
.@.@....@@.@@..@@.@.
.@.@.@@.......@.....
@....@@@.@.@.@@@@.@.
@@.@.@@@@@@@..@.@@..
@@.@@@.@.@.@@......@
@@...........@.@@@@@
@@@.@.@.@.@@.@..@@@@
10
12 15 0
2 8 0
17 15 0
13 5 0
19 2 1
3 7 1
0 12 1
13 17 2
6 17 2
1 5 2

13 13 0
15 12 0
19 6 0
7 2 0
18 3 1
2 18 1
19 15 1
7 3 2
6 11 2
8 17 2
