width 20
height 20
@@@@@@@@.@@@@.@...@@
@@@@@@.....@....@@.@
@@@@@@@@.@@.@.@.....
@@@@@@@......@..@@@@
@@@@@.@@@.@.@.@.@.@@
@@@@.....@..........
@@@@.@.@@@@@.@@.@@@.
@@.@.@...@...@..@@@@
.....@.@.@@@.@.@.@@@
@@.@..@..@@@.@...@@@
...@.@.@@.@@.@.@.@@@
@.@........@@@.@..@.
@@@@.@.@.@......@...
@@@@@...@@@@.@@@@@@.
@@@@@@.@..@...@@@@..
.@.@@....@.@.@@@@.@.
.....@.@.@..@@@@....
.@@@.@@....@@@@@@.@.
..@@@.@@.@@@@@@@...@
@........@@@@@@..@.@
10
12 3 0
0 16 0
10 11 0
15 0 0
17 12 1
1 11 1
2 9 1
6 7 2
6 16 2
2 7 2

12 12 0
8 7 0
8 12 0
14 11 0
15 0 1
15 9 1
6 10 1
9 1 2
4 17 2
15 19 2
