width 20
height 20
.....@...........@@@
....................
........@.....@.....
....................
..@.....@..@........
....@...............
.......@.....@......
......@..@.......@..
....................
.........@@....@....
...@.....@.@.@......
.@....@.............
...........@........
.................@.@
........@..@........
....@...............
....................
.....@........@.....
@@........@.......@@
@@..@@...@@.......@@
1
3 12 0

7 5 0
