width 20
height 20
.......@..@@..@.....
............@.......
@...................
@......@............
.........@@@......@.
.@....@.............
.........@....@.....
.....@......@......@
..@....@...@..@....@
....................
....................
....................
.............@@@@...
......@.......@@@...
............@@@@@...
..@...@.............
..........@..@.@....
.@..@..............@
..@.................
....................
1
17 3 0

11 5 0
