width 20
height 20
@@..@@@.........@@@@
@..................@
@........@.......@..
....................
.....@..............
..@..........@....@.
.@....@.@...........
.....@.@..@.@.@.....
....................
..............@.@...
.....@..@...........
...................@
....................
..@.........@.......
...@.............@..
.@......@...........
....................
@@.@................
@@@@......@...@....@
@@@@..@...@@......@@
1
8 7 0

11 7 0
