width 20
height 20
..@.................
.................@..
....................
................@...
@......@....@.......
..@@@@..............
..@..@..............
.....@...@.....@.@..
...........@..@.....
......@.............
...........@..@.@...
......@..@.......@..
....................
..@...@.....@...@...
..@.@...............
.......@....@.......
.........@..........
.....@.........@...@
.........@@.........
@..@....@@@........@
18
13 15 0
0 18 0
14 3 0
13 17 0
15 19 0
8 9 0
9 4 0
8 8 0
12 1 0
0 3 0
4 9 0
8 11 0
9 1 0
13 4 0
18 13 0
6 0 0
13 19 0
16 8 0

18 10 0
3 0 0
12 3 0
0 1 0
11 1 0
4 7 0
8 5 0
8 8 0
16 1 0
14 2 0
19 1 0
7 18 0
7 11 0
11 15 0
1 0 0
16 5 0
14 16 0
17 9 0
