width 20
height 20
@..@@@@..@@@@@.@.@.@
.@...@..@.@@@@......
.@.@@.@...@@@@@.@@.@
........@@.@.@@.@..@
@.@.@@@..........@..
@@..@@@@.@.@@@@.@@.@
@@@.@@@@@...@@@@@...
@@@@@@@@@@.@.@@@..@.
@@@@@@@.......@.@.@@
@@@@@...@.@@@@....@@
@@@@@@.@@@@@@@@.@@..
@@@@@@@@@@@@@....@.@
@@@@@@@@@@@@@@.@.@.@
@@@@@@@@@@@.@@@.....
@@@@@@@@@@..@@@@.@@.
@@@@@@@@@@@...@..@.@
@@@@@@@@@..@.@.@.@..
@@@@@@@@@@.@.......@
@@@@@@@@@@...@.@.@..
@@@@@@@@@@@@..@...@.
5
19 16 0
13 15 0
15 10 1
13 19 1
12 16 2

9 4 0
18 11 0
10 4 1
19 6 1
14 0 2
