width 20
height 20
....@@@@@@@@@...@@@@
@@.@@@@@@.@@@.@...@@
@....@@@...@@@@@@.@@
..@.@@@.@.@.@@@@..@.
@.@..@..@...@.@@@...
@..@@.@.@.@@......@@
@@.@@.....@.@@@@@.@@
@...@.@.@...@@.@....
.@@...@@..@......@@.
..@.@..@.@@@@.@.@@@@
@..@@.@.@@@@@@...@.@
@.@@.....@@@@@@.@@..
.....@@.@@@@@......@
.@@.@..@@@@@@.@.@.@@
...@@.@...@@@@@@...@
@@......@..@@@@@@.@@
...@.@.@..@@@@@@..@@
@.@..@@@@@@@@@.@.@@@
...@@@@@@@@@@....@@@
@.@@@@@@@@@@@@.@..@@
10
1 7 0
14 8 0
7 14 0
5 7 0
2 1 1
11 3 1
14 12 1
1 19 2
3 3 2
3 15 2

1 7 0
2 1 0
4 11 0
13 0 0
2 15 1
16 8 1
17 12 1
14 0 2
1 12 2
5 14 2
