width 35
height 35
@@@@@@.............................
@@@@@@........@..................@.
.....@....@.@............@.........
..............@..@.@.........@...@.
............@.............@...@....
.....@.@.............@...@.....@...
..........@................@.......
............@.....@................
...@...@@....@...................@.
....................@....@.........
.@..............@.......@..@.......
....@.....@.@.........@...........@
@..................@......@...@.@@@
@..@.@....@.......................@
............@.....@.....@.@........
.........@.................@.......
.@@..............@...............@.
....@.......@.......@....@.@@...@..
............@.........@............
.@.....................@...........
...@...@.....@..........@..........
.........@......@.....@...@......@.
.....................@.@....@.....@
.......@...@..................@....
................@....@........@@@@.
......@@......@....................
..@.......@.@......................
...@.@............@.....@.........@
.............@.@..........@.@.....@
............@......................
...@...........@...................
..................@........@....@..
........@...........@........@.....
......@............................
...................................
25
33 5 0
30 25 0
16 17 0
24 19 0
15 4 0
17 8 0
7 27 0
6 21 0
7 24 0
5 20 0
20 12 0
3 17 0
25 33 0
31 14 0
21 8 0
3 2 0
6 16 0
17 13 0
6 22 0
12 22 0
2 24 0
26 5 0
8 2 0
9 11 0
34 2 0

10 5 0
2 2 0
2 31 0
17 29 0
0 5 0
15 6 0
20 10 0
7 19 0
4 13 0
7 21 0
0 34 0
30 16 0
31 11 0
4 15 0
12 12 0
1 7 0
14 17 0
17 27 0
0 26 0
19 0 0
5 10 0
6 13 0
23 13 0
3 9 0
31 1 0
