width 20
height 20
@@@@@....@@@@@@@@@@@
@@@@..@.@@@@@@@@@@@@
@@@@@@...@@@@@@@@@@.
@@@@@.@.@@@@@@@@@@..
@@@@@......@@@@@@.@.
@@@@@.@.@.@.@@.@....
@@@@@@.@........@@@.
@@@@...@@.@.@.@@@...
@@@..@.@...@@@..@@.@
.@@.@.@.@.@.@.@.....
................@.@.
@.@.@@.@@.@@.@@@..@.
...@..@@@@..@...@@..
.@.@.@.@.@.@@@.@.@@.
@@@.................
@...@.@@.@@.@.@.@.@.
..@.@@@@@@@@@..@.@..
@..@@@@@@@@@..@..@@.
..@@@@@@@@@@@...@...
@.@@@@@@@@@@@@.@..@.
9
0 9 0
1 10 0
4 14 0
17 11 0
14 14 0
9 7 0
6 4 0
13 14 0
11 6 0

3 9 0
4 7 0
13 16 0
7 9 0
10 4 0
18 12 0
18 3 0
6 0 0
7 14 0
