width 20
height 20
....................
..@.@.........@.....
....................
....................
.....@......@.@.@...
.........@...@......
...@................
.........@......@...
...........@......@.
..............@.....
.......@............
...@.....@..@....@..
....................
..@...@..@..@.......
...@.......@..@..@..
....................
........@...........
@..@.....@......@..@
@..............@...@
@..................@
4
10 5 0
5 16 0
4 6 1
16 6 2

8 9 0
15 15 0
13 11 1
4 18 2
