width 20
height 20
..............@@@@@@
...@..........@@@.@.
........@...........
....@..@..........@.
..........@....@....
...@................
.........@...@.@....
......@...@.........
.....@..............
..@.........@.......
........@......@....
....................
..@......@..@.......
.....@.........@@...
....................
.@..@...@....@......
.....@..............
.................@..
@...@.@.............
@.......@...........
4
8 17 0
0 16 0
4 14 1
15 15 2

17 12 0
2 14 0
7 14 1
7 6 2
