width 20
height 20
@@@@@@@@@@@@@@.@@@@@
@@@@@@@@@@@@@...@@@@
@@@@@@@@@@@@@.@.@@@@
@@@@@@@@@@@@@..@@@@@
@@@@@@@@@@@@..@.@@@@
.@@@@@@@@@@@@....@@@
.@@@@@@@@@@@..@.@@@@
..@@@@@@@.@@@.@@@@@@
.@.@@.@@...@..@@@@@@
.........@...@.@@@@@
@@@@.@@@@@.@......@@
@@.@@@@@.@@.@.@@@@@@
@.....@.......@...@@
@@@@.@.@@@@.@@@@.@.@
@@@....@............
.@.@@@..@.@.@.@.@.@.
....@@@....@@..@@@..
.@.@.@..@.@@@.@@@@@.
.@.....@@@@@@@@@@@@.
..@@.@.@@@@@@@@@@@@@
8
7 17 0
11 15 0
1 16 0
8 12 0
0 15 0
14 14 0
12 6 0
0 7 0

8 8 0
15 4 0
12 14 0
6 18 0
19 17 0
9 8 0
0 16 0
0 18 0
