width 20
height 20
@..@@@@@@@@.@@..@.@.
@@..@@@@@@.....@....
@.@...@@@.@.@@.@@.@.
....@@.@....@....@..
@@@......@@..@@@@..@
@@@@.@.@@@@@.@@..@.@
@@@@@@@@@@....@@.@.@
@@@@@@@@@@@.@..@....
@@@@@@@@@@@..@.@@@.@
@@@@@@@@@@@.@@.@@@.@
@@@@@@@@@@@@....@...
@@@@@@@@@@@@@.@.@@.@
@@@@.@@..@@@@@..@...
@@@...@.@.@@@..@.@.@
@@@@.@.......@......
@@@....@.@.@..@.@.@.
@@..@.@.@@@.@@@.@@..
...@@...@...@.@..@@.
@.@.@.@...@.....@@@.
@.@....@@..@.@@.@@@.
6
8 18 0
6 14 0
5 17 1
14 2 1
17 10 2
10 1 2

7 16 0
19 15 0
11 4 1
7 18 1
13 6 2
7 13 2
