width 40
height 40
@@@...@........@@@.@.............@.....@
@@@............@@...........@....@.....@
@@@@...@..............@...@..@....@@...@
@@@@.....@...@.@.......................@
.@@.......@.@..........@.....@.@.......@
....@.........................@...@.@..@
................@...........@...........
.@...........................@..........
........@.................@.............
.................@............@....@....
..............@......@...@......@.......
........@.@..@..@..............@........
....@.........@............@.........@@@
..@@............@.@.@..@..........@.@...
............@................@..........
@...@.........@...@.@...............@...
.@.........@............................
..@.....................................
....@.....................@.............
......@..@........@.............@..@....
.............@......@..@......@...@...@.
..@...................@..@..@...........
...@.........@.@..@...............@.....
......................@.....@.@.@....@..
...@............@....@.......@...@......
..@...........@.......@.............@@..
.................@......@......@....@...
.....@............@................@@@..
.........@@..@.....@...........@...@@...
...@.............@.........@....@.......
.......................@....@...........
.@...@........@...@..............@.@...@
.@@...............................@.....
.......................@@@@..@..........
......@.......@..@.....@@@@.............
...............@.@.....@................
...........@.......@........@...@.......
..@...@...@..............@.....@........
........@...@.@......................@..
........@................@...........@..
55
16 30 0
15 15 0
12 9 0
39 22 0
4 32 0
11 20 0
13 36 0
7 5 0
32 32 0
7 4 0
29 21 0
33 37 0
4 8 0
29 31 0
15 18 0
25 3 0
10 3 0
25 6 0
22 36 0
23 14 0
36 0 0
19 35 0
22 33 0
16 26 0
25 25 0
23 3 0
5 32 0
12 22 0
35 6 0
15 33 0
24 21 0
31 38 0
36 2 0
24 2 0
17 6 0
24 13 0
19 4 0
35 11 0
32 4 0
1 5 0
26 14 0
14 6 0
2 9 0
12 1 0
36 12 0
13 29 0
21 0 0
5 21 0
26 39 0
6 25 0
5 28 0
24 24 0
9 15 0
35 0 0
5 18 0

3 4 0
15 12 0
20 25 0
0 39 0
38 17 0
17 10 0
5 33 0
16 22 0
9 15 0
13 9 0
6 36 0
12 9 0
36 34 0
38 18 0
5 35 0
19 4 0
7 25 0
18 4 0
4 0 0
26 17 0
14 39 0
34 0 0
3 1 0
35 15 0
24 29 0
15 2 0
37 22 0
9 26 0
17 39 0
22 17 0
1 30 0
8 4 0
4 21 0
24 8 0
21 4 0
15 17 0
20 3 0
12 25 0
9 30 0
32 32 0
4 35 0
22 34 0
21 30 0
8 6 0
1 38 0
38 3 0
23 28 0
5 21 0
20 34 0
38 4 0
39 6 0
0 35 0
9 17 0
7 8 0
5 19 0
