width 20
height 20
@@.............@@...
@@..........@.......
....................
..@.....@.@.........
....................
...............@....
...@..............@.
........@...........
...@..@..@....@.....
....................
..@.....@...........
....@.@.......@..@..
...@....@.......@...
..........@.........
.....@..........@...
....................
...@.@.@..@.....@...
.........@.@........
....@..@............
....................
10
18 16 0
15 3 0
8 14 0
10 1 0
4 2 1
0 4 1
0 15 1
13 0 2
12 5 2
7 11 2

6 15 0
2 16 0
4 1 0
5 10 0
18 8 1
7 0 1
7 8 1
13 2 2
15 2 2
7 12 2
