width 20
height 20
....................
....................
...........@.@...@..
..@.@...............
@..............@....
...@................
......@.......@.....
............@@@.....
@.......@.....@.....
.......@..@.....@...
......@.............
@@........@..@......
@@......@...@...@...
@@.....@.........@..
.....@.@............
.......@@..@....@...
....@..........@....
...@................
.............@......
....@@@............@
10
1 14 0
11 3 0
2 16 0
3 2 0
19 5 1
17 15 1
15 12 1
14 1 2
5 3 2
7 17 2

3 2 0
3 1 0
9 9 0
18 16 0
19 6 1
6 13 1
18 7 1
19 5 2
15 14 2
1 7 2
