width 20
height 20
...........@@@@@@@@@
.........@..........
.....@........@.....
..........@.....@...
........@...........
....................
...@................
.....@....@...@@....
........@...........
.@.............@....
....................
..........@.....@...
........@....@...@@.
..@..........@......
....@...............
....................
.@.@.@....@.........
...........@..@.@.@.
.....@.@............
...........@....@.@.
10
2 16 0
14 15 0
12 12 0
0 11 0
2 5 1
17 10 1
11 7 1
6 11 2
2 8 2
11 10 2

2 3 0
8 9 0
12 12 0
4 1 0
17 7 1
9 5 1
0 18 1
19 1 2
0 8 2
0 2 2
