width 20
height 20
....................
.................@..
.........@.@........
..........@.@..@....
................@...
.@..................
..@......@.....@....
@.............@.....
.....@.@............
..............@.@..@
.............@.....@
....................
...@...@..@..@..@...
.@..................
........@...........
....@......@@.......
............@.......
.........@..........
..........@.@@@@....
@..@........@@@.....
10
17 0 0
8 7 0
14 16 0
17 3 0
0 11 1
3 6 1
15 16 1
13 15 2
13 3 2
11 16 2

2 19 0
19 19 0
16 19 0
2 11 0
4 10 1
6 13 1
3 13 1
4 8 2
0 17 2
11 19 2
