width 20
height 20
.............@@@@@@.
.....@........@.....
.@.............@....
.......@............
............@...@...
.....@..............
....@...............
........@.....@.....
.@.....@..@..@...@..
...@................
......@.....@.......
..........@.........
..............@...@.
.......@............
....................
.......@.@.......@..
@...........@.......
......@.............
.................@..
..................@.
3
0 5 0
12 7 1
7 6 2

12 8 0
16 12 1
19 19 2
