width 20
height 20
....................
...@................
.................@..
.....@..............
.......@...@........
.......@......@.....
............@...@...
.@......@.@.@.......
.....@.....@........
.......@.......@....
...................@
.@.@......@.........
..................@@
....................
....@.....@.@..@....
..............@.....
...............@....
..@..@....@.......@@
..................@@
...@........@.....@@
3
9 14 0
13 14 1
18 8 2

11 15 0
7 18 1
17 3 2
