width 20
height 20
.....@@.............
.....@..............
..@........@...@....
..............@.....
..@....@............
.....@...@..@.@.....
....................
@......@..@.....@.@.
.....@..............
...........@........
.................@..
....@.@...@..@.@....
.......@............
..@.............@...
.............@......
.............@......
......@.@...@......@
....................
....@...............
....@@..............
3
9 4 0
14 14 1
7 1 2

10 5 0
0 11 1
10 2 2
