width 20
height 20
......@...@.@@@..@@@
.................@@@
.....@.@...........@
............@.@....@
.@.................@
...@..............@.
........@..@..@.....
............@...@...
....................
......@....@..@..@..
............@.......
@@@..@........@.....
................@...
..............@.....
................@@@@
.......@.@.......@@@
.................@@@
.................@@@
.......@.........@@@
.................@@@
4
2 6 0
13 9 0
6 15 1
11 13 2

1 1 0
3 15 0
2 5 1
11 13 2
