width 20
height 20
............@@@@..@@
.@..........@....@@@
..................@.
.......@............
....@....@....@...@@
..@..@............@@
@.........@.@.@...@@
@.................@@
......@........@.@@@
..............@..@@@
....@...@........@@@
.@.............@@@@@
....@....@......@@@@
..................@@
..................@@
...@.@........@.@@@@
.......@..@.....@@.@
...@................
.....@......@..@....
...............@....
4
7 8 0
6 4 0
6 13 1
7 4 2

7 7 0
16 14 0
1 6 1
6 16 2
