width 20
height 20
...@...@............
.@..............@...
................@...
.........@..@.......
....@.........@.....
....................
..@....@...@..@.....
...@................
......@.............
................@..@
.....@.@...........@
...@.......@........
........@.........@.
............@.......
.......@..........@.
.........@..@.......
..@............@....
...@....@...........
....@...@@@.@.......
......@@@@@.........
14
14 7 0
0 10 0
17 2 0
3 19 0
11 4 0
19 3 1
15 7 1
8 16 1
10 7 1
10 6 1
10 13 2
0 1 2
19 7 2
2 14 2

18 13 0
7 3 0
17 16 0
19 5 0
15 11 0
3 13 1
14 14 1
3 18 1
11 8 1
16 18 1
3 9 2
9 7 2
16 7 2
14 1 2
