width 20
height 20
...................@
................@...
......@.....@.......
.@.........@........
........@@..........
@...................
@.....@......@.....@
....@.....@.........
...@...@.@....@.....
....................
.....@..............
.....@.@.......@.@..
.............@......
............@.......
...@......@.....@...
........@...........
.................@..
...@........@.......
...........@........
....................
14
11 12 0
13 13 0
5 9 0
10 6 0
2 10 0
7 1 1
13 14 1
18 3 1
9 2 1
7 17 1
17 3 2
18 7 2
14 12 2
5 1 2

13 9 0
1 0 0
9 9 0
13 10 0
1 11 0
6 19 1
3 4 1
12 4 1
11 0 1
16 17 1
2 17 2
0 19 2
3 6 2
5 1 2
