width 20
height 20
....................
.@.......@..........
.............@......
....@...............
.......@.....@......
.@..................
.....@...........@@@
..@...@.......@..@@.
.............@......
.....@....@.........
...@.......@........
..........@.........
..................@.
.........@.......@..
.....@....@.........
....@....@.@..@.@...
........@...........
....................
.......@..@....@....
....................
14
10 17 0
9 19 0
19 10 0
19 19 0
19 0 0
18 3 1
10 7 1
6 4 1
5 10 1
14 4 1
16 7 2
12 1 2
6 15 2
12 4 2

15 10 0
18 1 0
19 11 0
12 18 0
19 15 0
2 16 1
6 11 1
8 3 1
8 6 1
4 0 1
4 4 2
18 15 2
15 2 2
12 5 2
