width 20
height 20
...............@@...
....................
@.............@.....
.....@...@..@.......
.....@..............
....................
..@.....@..@...@....
.........@..........
.....@......@.......
...@............@...
.......@...@........
...............@....
........@..@........
....@.....@...@.....
....................
...@...@.......@..@.
..........@.@.......
.@.....@............
............@.......
............@...@...
10
12 7 0
2 1 0
0 10 0
8 16 0
4 5 0
18 0 0
19 0 0
0 17 0
5 19 0
13 8 0

0 18 0
2 0 0
18 4 0
13 16 0
16 14 0
19 2 0
17 3 0
9 18 0
7 11 0
1 19 0
