width 20
height 20
...................@
....................
............@.......
....@...............
....................
...@.......@...@....
.............@......
......@.@...........
...........@.@......
..@..............@..
.....@..............
..@......@.......@@@
..............@..@@@
.....@..@...........
.........@....@.....
.............@..@...
....@.@....@........
.........@..........
....................
.............@@.....
7
19 1 0
2 13 0
5 15 0
13 3 1
10 8 1
13 11 2
14 6 2

17 3 0
12 10 0
2 16 0
17 4 1
15 12 1
19 16 2
10 1 2
