width 20
height 20
..@.......@.........
...............@....
....................
@...............@...
@.....@.............
..........@......@..
..@....@...@........
.....@.......@......
..@..............@..
..............@.@...
.........@@..@......
........@.........@.
.....@.@............
..............@.....
......@....@.@......
@..@@@....@.........
....@........@@..@..
.................@@.
....@............@@@
.................@@@
6
15 9 0
9 6 0
3 17 0
3 1 0
17 7 0
12 13 0

12 16 0
7 3 0
2 14 0
14 5 0
11 5 0
11 8 0
