width 20
height 20
@@.................@
@.........@......@..
@.............@.....
......@.............
..........@.........
........@.........@.
....................
......@.@.......@...
.......@...@.@.@....
....................
......@....@.......@
....@...............
..............@.@...
.......@.@..........
....@...@.....@.....
.............@......
............@...@...
.@.......@..........
....................
......@...........@@
10
1 8 0
10 14 0
11 9 0
11 2 0
5 11 1
10 18 1
0 9 1
15 9 2
17 13 2
11 3 2

19 18 0
11 15 0
11 9 0
1 19 0
3 2 1
10 10 1
2 9 1
15 9 2
15 7 2
18 3 2
