width 20
height 20
....................
....@.......@.......
...@...@.@.@........
...................@
.@....@............@
............@...@..@
...@........@@...@..
............@.......
...........@........
..@...........@.....
.....@....@.........
...@...@.....@......
....@...............
........@...@.......
.............@......
@@@.................
.........@..@.....@.
..............@....@
....................
.........@......@...
10
13 2 0
12 11 0
16 12 0
18 11 0
19 11 1
12 9 1
5 16 1
11 6 2
12 14 2
0 2 2

10 9 0
11 12 0
0 14 0
13 15 0
19 8 1
12 8 1
9 11 1
6 1 2
0 2 2
5 6 2
