width 20
height 20
.@@@@........@.....@
...@@..@............
.............@.@....
......@...........@.
....................
.@........@.@.......
.@..@............@..
.........@.@........
....@.....@.@.......
....................
..............@...@.
..@.................
........@.@.........
..............@..@..
....................
......@.@..@........
...................@
....................
..@.....@...........
....................
1
2 10 0

4 9 0
