width 20
height 20
@@@@................
.@.@................
...@......@.@.......
.............@..@...
@................@..
........@...........
...............@....
....@.......@.......
.@..................
.......@...@@.......
.................@.@
..@.@......@.....@..
.............@......
.@....@........@....
.............@......
................@...
...@.....@.@...@.@..
.....@........@....@
................@..@
...................@
1
15 18 0

3 3 0
