width 20
height 20
@@@@@@@@@@@@@@@@@@@@
@@@@@@.@@@@@@@@@@@@@
@@@@@...@@@@@@@@@@@@
@..@..@@@@@@@@@@@@@@
.@.@.@.@@@@@@@@@@@@@
.....@.....@@@@@@@@@
@.@@...@.@@@@@@@@@@@
..@.@@@...@@@@@@@@@@
.@@.@.@.@.@@@@@@@@@@
.@......@...@@@@@@@@
@@@.@.@@@.@@@@@@@@@@
@@@@...@.@@..@@@@@@.
@@@@@.@...@@.@@@@...
@@@@....@......@.@.@
@@@.@@@..@.@.@......
@@..@...@@@...@.@@.@
@@@...@..@@@@..@@@..
@@@@.@@.@@@...@@...@
@@@@@@@@....@.@.@.@@
@@@@@@@@@@@..@.....@
2
17 18 0
6 15 0

3 7 0
11 19 0
