width 20
height 20
@@@@@@.@@@..@.@.@.@.
@.@@@...@..@........
...@@@.@.@..@@@@@.@.
@@.........@@@@@@@..
...@.@.@.@@@@@.@@@@.
.@..@@@..@.@@...@...
@@.@.@.@@....@.@..@.
........@@.@@....@..
@.@.@@.@.@.@@.@.@.@.
...@@.......@@@@....
@@...@.@.@.@@.@.@.@@
.@@.@.@..@.........@
.@.@....@..@.@@.@.@@
.@...@.@..@..@.@....
...@@.@@@.@@@...@.@@
.@....@.....@.@.....
@@@@.@.@.@.@..@.@.@@
@@..@@....@@@.@..@@@
@@.@.@.@@@@@@.@.@@@@
@.......@@@@@@...@@@
2
19 7 0
5 14 0

10 12 0
5 14 0
