width 20
height 20
.....@@@..@.@.@.@@@@
@.@@..@.@.......@@@@
..@.@@....@.@@.@@@@@
@......@.@..@@.@.@@@
@@@.@@.@@@@..@...@..
@@@@@@....@.@..@...@
@@@@@@@.@..@@.@..@@@
@@@@@@@..@.@@@..@.@.
@@@@@@@.@..@@@@.....
@@@@@@@..@.@.@.@.@.@
@@@@@@..@@@.....@@..
@@@@@@@@@@@@.@@....@
@@@@@@@@@@@@@@@@.@..
@@@@@@@@@@@@@@@@.@@@
@@@@@@@@@@@@@@@@@@@@
@@@@@@@@@@@@@@@@@@@@
@@@@@@@@@@@@@@@@@@@@
@@@@@@@@@@@@@@@@@@@@
@@@@@@@@@@@@@@@@@@@@
@@@@@@@@@@@@@@@@@@@@
3
19 8 0
16 9 0
19 12 0

12 10 0
17 8 0
0 2 0
