width 20
height 20
@@.@@@.@.@...@@@.@@@
@@..@..@...@@.@...@@
@@@.@@...@.@....@..@
....@.@.@....@.@..@.
@@.@@..@@@.@..@@@...
@.....@@@@@@.@@@@@.@
..@@@@.@@@...@@@@@@@
@..........@@@@@@@@@
..@@@@.@.@.@.@@@@@@@
@.@.....@.....@@@@@@
@@..@.@..@.@.@@@@@@@
...@@.@@..@@@@@@@@@@
@.@.....@..@@@@@@@@@
@.@.@.@@..@@@@@@@@@@
@@@@@.@@@..@@@@@@@@@
@@@.@.@...@@@@@@@@@@
@.....@@.@@@@@@@@@@@
@.@@.@@@....@@@@@@@@
@...@@@..@.@@@@@@@@@
@@.@@@@.@....@@@@@@@
3
0 11 0
17 3 0
11 17 0

0 11 0
19 3 0
7 10 0
