width 20
height 20
@@@..@@@@@@@@.@.@@.@
@@@@..@.@..@.....@.@
@@@@.@....@@@.@@....
@@@@..@.@..@....@.@.
@.@.@....@@.@@.@...@
......@.@.@.@.@.@.@@
.@.@.@........@.....
..@..@.@@.@.@...@@.@
.@@@.@@@@@..@@@@@@..
..@@@@@@@@@..@.@@@.@
@@@@@@@@@@@@......@@
@@@@@@@@@@@@@.@.@..@
@@@@@@@@@@@@@@..@.@@
@@@@@@@@@@@@@@@@@@@@
@@@@@@@@@@@@@@@@@@@@
@@@@@@@@@@@@@@@@@@@@
@@@@@@@@@@@@@@@@@@@@
@@@@@@@@@@@@@@@@@@@@
@@@@@@@@@@@@@@@@@@@@
@@@@@@@@@@@@@@@@@@@@
3
14 12 0
11 9 0
2 5 0

9 6 0
15 3 0
14 7 0
