width 20
height 20
....................
...................@
..................@@
............@.......
...................@
........@.@..@......
....................
....................
.....@.....@..@.....
.....@...@..........
.....@..............
..............@.@...
........@.@.........
....................
.@..@............@..
...............@....
..@...@.......@....@
.....@..............
....................
.@@...@....@@....@..
10
14 14 0
3 9 0
9 0 0
16 12 0
5 1 0
9 4 0
13 16 0
12 9 0
14 10 0
3 14 0

0 0 0
18 19 0
2 18 0
1 18 0
12 5 0
12 10 0
1 8 0
1 2 0
14 4 0
3 5 0
