width 20
height 20
...@@@.@@@@@@@@@@@@@
.@......@@@@@@@@@@@@
@..@@.@...@@@@@@@@@@
..@@...@.@@@.@@@@@@@
.@.@.@@@@@@...@@@@@@
...@..@.@@.@@..@@@@@
@@..@@@.......@@@@@@
...@.@.@.@.@.@@@@@@@
.@........@@....@@@@
.@.@.@.@@..@@.@..@@@
..@...@.@@@@...@.@@@
.@@@@.....@.@@.@@.@@
@@@@@@@.@@@.......@@
@@@@....@@@.@.@@.@@@
@@@@@.@@.@@..@@@@@@@
@@@@@.@@..@.@@@@@@@@
@@@@.....@@.@@@@@@@@
@@@@@.@.@@..@@@@@@@@
@@@@@@..@@@.@@@@@@@@
@@@@@@@@@@@..@@@@@@@
15
12 7 0
1 7 0
10 5 0
7 10 0
0 0 0
8 16 1
0 11 1
17 12 1
0 1 1
11 17 1
7 6 2
14 10 2
1 5 2
5 16 2
12 3 2

5 5 0
13 5 0
16 10 0
5 3 0
8 16 0
4 13 1
3 8 1
12 4 1
0 3 1
11 6 1
4 7 2
14 12 2
11 14 2
12 8 2
6 3 2
