width 20
height 20
@@@@@@@@@@.........@
@@@@@@@@.@.@.@.@.@..
@@@@@@@.....@@@@..@@
@@@@@@..@@.@..@@@.@@
@@@@...@..@@.@.@.@@@
@@@@@@...@.@......@.
@@@@@@.@.....@.@.@..
@@@@@...@.@.@@@@..@.
@@@@@@.@.@.@.@.@@...
@@@@@@...@.....@.@.@
@@@@@..@..@.@.@@....
@@@@@@.@@....@@@.@@.
@@@@@@..@@.@.@@@..@.
@@@@@@@@@@@..@@@@..@
@@@@@@@@@@.@..@@@@.@
@@@@@@@@@@.@.@..@@..
@@@@@@@@@@...@.@@@.@
@@@@@@@@@@.@......@@
@@@@@@@@@@@@.@.@.@@@
@@@@@@@@@@....@....@
15
19 6 0
11 6 0
17 10 0
16 1 0
12 19 0
13 3 1
10 11 1
5 4 1
15 19 1
12 9 1
10 1 2
19 8 2
16 4 2
9 10 2
10 8 2

19 6 0
12 0 0
12 5 0
12 12 0
12 17 0
12 3 1
17 10 1
18 1 1
17 12 1
18 13 1
6 6 2
19 5 2
9 11 2
9 10 2
9 2 2
