width 20
height 20
@@@@@...@....@@@@@@@
@@@@@@@...@@...@@@@@
@@@@@@@@@@...@@@@@@@
@@@@@@@....@.@@@@@@@
@@@@@@@@.@..@@.@@@@@
@@@@@@@@@..@@@.@@@@@
@@@@@@@@.@..@@..@@.@
@@@@@@@@...@.@.@...@
@@.@@@...@.@....@.@.
@@..@@@.@@.@@.@.....
@@.@.@.@...@..@@.@.@
@@.......@.@@..@..@@
@@@.@.@.@...@.@@.@@@
@@@@...@.@@...@.@@@@
@@@@@.@@..@@.@..@@@@
@@@@.....@@..@.@.@.@
@@@@@.@@@@@@.......@
@@@@@@@@.@@@.@.@@.@@
@@@@@@@......@...@@@
@@@@@@..@.@@.@.@.@@@
17
8 7 0
11 18 0
6 8 0
15 16 0
9 1 0
17 9 0
16 19 0
17 17 0
19 9 0
7 9 0
14 16 0
16 7 0
14 7 0
18 15 0
12 18 0
4 10 0
13 16 0

8 7 0
15 14 0
18 9 0
7 1 0
16 10 0
9 12 0
8 14 0
6 10 0
19 9 0
8 6 0
9 19 0
6 19 0
12 8 0
16 16 0
2 10 0
10 5 0
16 9 0
