width 20
height 20
..@....@@....@@@@@@@
@.@@@@.@@@@.@@@@@@@@
.......@.....@.@.@@@
@@.@.@...@.@.@......
@@..@.@@.@@@...@@.@.
@@@@......@@@.@@@@@.
@@...@.@@@@@@@@@@@@@
.@.@.@....@@@@@@@@@@
....@@.@.@@@@@@@@@@@
.@.@@@@...@@@@@@@@@@
@...@@.@.@@@@@@@@@@@
..@.....@@@@@@@@@@@@
.@@@@.@@@@@@@@@@@@@@
.@@@@@@@@@@@@@@@@@@@
.@@@@@@@@@@@@@@@@@@@
@@@@@@@@@@@@@@@@@@@@
@@@@@@@@@@@@@@@@@@@@
@@@@@@@@@@@@@@@@@@@@
@@@@@@@@@@@@@@@@@@@@
@@@@@@@@@@@@@@@@@@@@
17
11 0 0
2 3 0
7 9 0
3 10 0
8 3 0
5 5 0
7 11 0
5 12 0
1 2 0
7 7 0
3 11 0
0 14 0
9 2 0
16 2 0
6 8 0
6 11 0
11 2 0

6 10 0
5 5 0
1 11 0
9 0 0
6 2 0
4 6 0
4 11 0
17 3 0
2 3 0
10 2 0
8 2 0
7 5 0
4 2 0
19 5 0
8 10 0
5 11 0
3 11 0
