width 20
height 20
.@@@@.@@@@@........@
..@@..@@@@@@.@.@@.@@
.@@.@..@@@@@@@.@@@@.
....@@..@@@@.@.@@@..
.@@.@.@..@@.....@.@.
@.......@@..@.@.@.@.
..@@.@.@@@@..@......
@.@@@.......@@@.@@.@
..@@@@.@.@@@@.....@.
@@@@@@@.....@@@.@.@.
@@@@@@@@.@.@@@@@....
@@@@@@@@@@@@@@@@@.@.
@@@@@@@@@.@@@.@@..@.
@@@@@@@...@@@.@..@..
@@@@@@..@..@....@..@
@@@@@@@..@...@@@@@@@
@@@@@@@@.@.@@@@@@@@@
@@@@@@@@@@.@@@@@@@@@
@@@@@@@@@@..@@@@@@@@
@@@@@@@@@..@@@@@@@@@
17
19 2 0
12 6 0
5 5 0
10 15 0
7 7 0
6 3 0
15 8 0
8 7 0
13 12 0
14 3 0
7 5 0
9 19 0
0 4 0
10 10 0
0 0 0
15 0 0
6 14 0

12 3 0
11 6 0
14 4 0
5 4 0
15 14 0
19 2 0
18 3 0
10 18 0
1 1 0
12 6 0
14 0 0
11 15 0
18 6 0
8 7 0
5 2 0
12 1 0
19 3 0
