width 40
height 40
...@....................................
...........@.@...@..........@...........
........................@............@..
.........................@.@.......@....
..@................@..@......@.....@....
.......@.......@....@.......@..@........
.........@......@..................@.@..
...@..................@.@...............
.....@....@...@..@...........@..........
........@............@.....@............
...............@........@.......@..@....
..@....@....@....................@......
@@@...@....@.....@....@...@.............
@@.....@..............@............@@...
........@.....@.......@....@..@.......@.
...........@.......@....@....@..@...@..@
.......................................@
...@@....@.@...........@.@.....@..@....@
.@...@..@.....@.......@.................
............@@.............@..@.........
.....@.@...................@@........@..
.......@@..........@...@................
......@@@......................@.@......
.@.@.............@....@......@..........
.....@........@......@...@.......@......
........@......@..................@.@.@.
........@.......@.....@..........@......
........@..................@......@....@
.........@......................@......@
...@..@.......@......@......@.@........@
.........@..@...@........@........@.....
...................@..@.....@...........
......@..........@.....................@
..........@..@.......@.....@.@.@........
......@...........@.@............@...@..
...@.........@............@.............
.......................@...@..@.@....@..
........................................
.......@.............@..................
........@.........@.........@@..........
41
17 30 0
8 5 0
14 33 0
37 7 0
13 11 0
39 11 0
8 8 0
9 12 0
36 16 0
32 38 0
31 34 0
13 28 0
8 23 0
16 28 0
19 37 1
5 1 1
36 0 1
11 35 1
11 14 1
21 1 1
15 39 1
0 38 1
8 30 1
26 16 1
34 7 1
24 0 1
16 5 1
0 36 1
36 4 2
26 11 2
17 10 2
37 15 2
17 19 2
8 19 2
38 19 2
10 23 2
10 25 2
38 32 2
6 8 2
31 25 2
21 30 2

27 7 0
29 2 0
35 21 0
29 10 0
26 34 0
39 11 0
18 14 0
7 23 0
1 39 0
5 35 0
14 3 0
39 8 0
14 13 0
16 28 0
36 4 1
14 10 1
0 11 1
39 19 1
3 4 1
14 33 1
35 0 1
33 39 1
37 16 1
24 20 1
1 36 1
0 39 1
35 9 1
37 7 1
1 17 2
39 37 2
6 39 2
39 7 2
2 33 2
20 15 2
18 27 2
32 4 2
39 1 2
1 2 2
33 1 2
4 9 2
19 32 2
