width 40
height 40
....................@.........@.......@@
......@..........................@....@@
@.@.....@.....@.@.......................
..@..@.......@......@...@.....@.....@...
........@..@............................
....@.@....................@..@....@....
......@....@.@.@.............@.@........
.@........@...........@.@...@...........
....................@............@......
....@.....@...@..@.....@................
..........@................@...@........
@.....@.....@.....@......@.......@..@.@.
@@.@.....@....@.........@....@..@.......
.......@...........@....................
...................@....@...............
.....@..@..@.@.........@.............@@@
..........................@........@....
..............@.@...@......@............
..@.@.@.................@...............
......@.@..............@.............@..
..@.@........@..@..............@........
.......@............@.......@....@......
...@..@...@.............@.@......@.@....
.........@...............@..............
........@...@..@.@.@.@..................
.......@...................@....@@.@....
..................................@.....
...........@.@@..@.@...................@
..@..@........@@.......@.......@.....@..
.........@.....@............@...........
...........................@..@.........
..........@.....@.@.....@.......@.......
..@...........................@...@.....
.............@....@.@...@............@..
..............@.@...........@.@...@.....
..................@....@................
..@....@..................@.......@.@...
...@.@......@.....@........@.....@......
@...............@.......................
@........@..............................
38
1 16 0
8 31 0
0 33 0
4 19 0
19 7 0
27 23 0
17 31 0
5 2 0
3 1 0
9 2 0
35 2 0
8 16 0
16 9 0
34 16 1
11 10 1
18 30 1
16 7 1
35 34 1
25 33 1
20 38 1
2 24 1
29 32 1
23 16 1
3 7 1
0 32 1
23 18 1
12 32 2
1 26 2
19 11 2
29 14 2
4 21 2
22 23 2
35 27 2
25 15 2
1 33 2
36 14 2
9 20 2
29 34 2

10 16 0
39 20 0
24 37 0
31 4 0
0 35 0
3 10 0
17 32 0
17 10 0
39 25 0
6 15 0
31 39 0
11 14 0
0 8 0
1 37 1
39 29 1
39 8 1
15 25 1
2 0 1
14 0 1
14 11 1
20 22 1
12 28 1
8 35 1
35 37 1
27 6 1
8 33 1
7 3 2
7 24 2
23 31 2
5 39 2
26 31 2
36 2 2
18 8 2
11 13 2
3 16 2
27 23 2
9 21 2
5 21 2
