width 20
height 20
@@@@@@@@@@@@@@@@@@@@
@@@@@@@@@@@@@@@@@@@@
@@@@@@@@@@@@@@@@@@@@
@@@@@@@@@@@@@@@@@@@@
@@@@@@@@@@@@@@@@@@.@
@@@@@@@@@@@@@@@@@...
@@@@@@@@@@@@@@@@.@.@
@@@@@@@@@@@@@@@.....
@@@@@@@@@@@@@@@@.@@.
@@@@@@@@@@@@@@@..@@.
@@@@@@@@@@@@@...@@@.
@@@@@@@@@@@@@.@.@...
@@@@@@@@@@@@@@@@@@.@
@@@@@@@@@.@@@@@@.@.@
@@@@@@@@..@.@@.@....
@@@@@@@..@.......@.@
@@@@@@..@@.@.@@@.@@@
@@@@@@@.....@.....@@
@@@@@@@@@.@@@@.@.@@@
@@@@@@@@@...@@@@@@@@
8
7 17 0
17 7 0
7 16 0
18 6 0
16 9 0
16 16 0
16 14 0
11 15 0

15 7 0
9 14 0
15 10 0
18 4 0
18 14 0
16 17 0
18 6 0
19 8 0
