width 20
height 20
@@@..........@......
....................
...........@.......@
..@.................
...@...@............
........@.........@.
............@.@.....
.....@..........@...
.@.....@.@..........
.............@......
....@.@.@.....@.....
..........@..@...@..
..@............@....
......@.@...........
...................@
....................
....@...........@...
.......@......@.....
....................
....................
6
1 7 0
8 4 0
9 15 0
7 13 0
5 2 0
10 2 0

5 5 0
13 12 0
6 9 0
17 7 0
15 2 0
17 18 0
