width 20
height 20
@...................
@..@................
@....@...@.........@
@@..@......@.@......
....................
..........@.@..@....
..............@.....
........@@..@.@.....
....@@..@@.....@....
...........@......@.
.......@............
....................
.....@......@...@.@.
....................
................@...
..@......@.@..@.....
.....@..............
...................@
.................@..
.@@............@....
6
12 10 0
0 11 0
16 7 1
16 5 1
4 10 2
9 12 2

16 4 0
2 12 0
13 4 1
19 8 1
4 9 2
5 11 2
