width 20
height 20
@@@@@@@@@@@@@..@@@@@
@@@@@@@@@@@@@@..@.@@
@@@@@@@@@@@@@..@...@
@@@@@@@@@@@@@.@..@..
@@@@@@@@@@@@..@@.@.@
@@@@@@@@@@@@@...@...
@@@@@@@@@@.@.@.@.@.@
@@@@@@@@@..@........
@@@@@@@@@@...@.@.@.@
@@@@@@@@@..@@..@.@..
@@@@@@@.@@.@@@.@@..@
..@@@@@....@@@@@@@@@
@.@@.@.@.@@@@@@@@@@@
.....@.....@@@@@@@@@
@.@@...@.@@@@@@@@@@@
@@@.@.@@@@@@@@@@@@@@
@......@@@@@@@@@@@@@
..@@.@..@@@@@@@@@@@@
@.@@..@.@@@@@@@@@@@@
@...@@@.@@@@@@@@@@@@
10
0 11 0
10 6 0
7 13 0
12 6 0
4 16 1
8 14 1
1 19 1
10 11 2
3 16 2
5 14 2

1 14 0
10 11 0
10 13 0
16 2 0
14 6 1
0 17 1
10 7 1
17 7 2
10 9 2
14 7 2
