width 20
height 20
@@@@@@@@@@@@@@@@@@@@
@@@@@@@@@@@@@@@@@@@@
@@@.@@.@@@@@@@@@@@.@
@@...@.@@@@@@@@.....
@..@.....@@@@@@@.@.@
.@..@.@.@@@@@@@@@...
...@..@.@@@@@@.@.@@.
@@.@.@@..@@@@.......
@@..@@@.@@@@@@.@.@@@
.@.@@@.@@@@.@.@..@@@
.......@@.@.@.@@..@@
.@@@.@...........@@@
@@@@.@@.@.@@@@.@@@@@
@@.....@.@@@@@@@@@@@
@@.@.@.@..@@@@@@@@@@
@...@....@@@@@@@@@@@
@@.@@@.@@@@@@@@@@@@@
@@@@@@....@@@@@@@@@@
@@@@@@@@.@@@@@@@@@@@
@@@@@@@@@@@@@@@@@@@@
14
3 5 0
16 8 0
7 15 0
11 9 0
2 4 0
19 5 1
0 9 1
18 4 1
7 11 1
13 9 1
2 14 2
9 17 2
15 9 2
14 6 2

8 15 0
6 11 0
0 10 0
5 4 0
4 6 0
15 11 1
7 15 1
19 7 1
2 15 1
4 4 1
2 5 2
3 3 2
0 6 2
5 10 2
