width 20
height 20
.@@@.....@@@@@@@@@@@
..@@@.@@.@.@@@@@@@@@
.@@@....@..@@@@@.@@@
.@@.@.@@.@..@@@@..@.
...........@@@@@.@..
.@.@.@.@.@@..@@....@
.@@...@@@@@.@.@.@@.@
..@@.@@@@@....@@...@
.@.@@@@@@@@.@..@@.@@
....@@@@@....@.....@
.@.@.@@@..@.@@@.@.@@
@........@@@@@@@@.@@
@@@.@.@.@@@.@@@@@@@@
@....@@@.....@@@@@@@
@@@@..@..@@.@@@@@@@@
....@.@.@.@....@@@@@
@@@........@.@@@@@@@
@@@.@@@@.@@...@@@@@@
@@@@.....@@@.@@@@@@@
@@@@@@.@..@@.@@@@@@@
14
2 9 0
14 15 0
8 10 0
12 9 0
5 2 0
10 13 1
12 18 1
0 5 1
11 7 1
1 7 1
0 4 2
3 17 2
9 16 2
6 18 2

0 1 0
18 5 0
2 11 0
18 7 0
8 10 0
7 2 1
6 19 1
17 11 1
16 2 1
8 3 1
3 12 2
19 4 2
16 7 2
5 6 2
