width 20
height 20
.......@..@@@@@.....
..........@@@@......
....................
..........@.....@...
...............@.@..
.@..................
..@.@...........@...
.....@....@.@....@..
......@..@.@.@......
....................
...@.@.....@.@...@..
....@....@..@.@.....
....................
...@...@.......@....
..........@.@.......
....................
....................
.........@..........
...............@@@@@
...@@..@........@@@@
6
10 12 0
13 11 0
11 13 1
18 13 1
9 15 2
16 4 2

10 12 0
1 8 0
11 2 1
18 13 1
18 1 2
12 10 2
