width 20
height 20
.@.......@@.@@@@@@@@
...@.@.@.@..@@@@@@@@
.@.@.@@..@@.@@@@@@@@
.@@@.@.@....@@@@@@@@
.@.@@....@.@@@@@@@@@
.....@@.@@....@@@@@@
.@.@.@@@@@@@@@@@@@@@
@@.@....@@@@@@@@@@@@
.@.@@.@..@@@@@@@@@@@
...@@.@@.@.@@@@@@@@@
.@@@....@@.@@@@@@@@@
.@...@@..@..@@.@@@@.
..@@.@.@.@.@.@..@@..
.@@.@@.........@.@.@
....@@@@.@.@.@......
@@.@.@.@.@.@.@@@.@@.
@@@@.@....@..@@@@@..
@@@@...@.@@@.@@@...@
@@@@.@..@@@@@@@.@.@@
@@@@@@.@@@@@@@....@@
12
4 3 0
5 0 0
18 13 0
12 5 0
11 3 0
17 19 0
6 18 0
5 7 0
17 14 0
7 16 0
7 13 0
2 6 0

14 11 0
7 13 0
18 17 0
1 5 0
0 10 0
6 7 0
10 14 0
4 11 0
6 4 0
15 14 0
8 2 0
5 10 0
