width 20
height 20
......@@....@.......
....................
......@....@...@....
....................
...@..@.............
.........@...@......
...@........@.......
.@..@..@............
.................@..
....................
.....@.@..@.........
....................
...@..@.@........@@.
.............@.@....
.........@......@...
......@.....@.......
....................
...............@....
@..............@@@..
@.....@@........@@..
10
14 3 0
18 7 0
7 18 0
17 2 0
15 15 1
15 11 1
1 6 1
15 16 2
6 14 2
8 19 2

4 18 0
1 1 0
3 2 0
13 2 0
1 0 1
0 17 1
17 5 1
3 10 2
5 5 2
19 2 2
