width 20
height 20
....................
@.....@........@.@..
@....@.............@
....................
.@..@.........@.....
..........@.......@.
...@................
......@.........@...
...............@....
........@...........
@.........@.........
@..@............@..@
....@............@..
.........@.@........
..............@.....
..@..............@..
......@.............
....................
....@..@@...........
.@................@.
10
17 17 0
13 19 0
1 0 0
0 18 0
3 13 1
1 11 1
17 18 1
2 12 2
10 9 2
11 2 2

18 9 0
7 10 0
14 17 0
16 6 0
19 4 1
5 11 1
7 3 1
5 0 2
19 7 2
19 13 2
