width 20
height 20
@@@....@@@@@@@@@@@@@
@@@@.@.@@@@@@@@@@@@@
@@@@@...@@@@@@@@@@@@
@@.@@.@@@@@@@@@@@@@@
@......@@@@@.@.@@@@@
.@.@@.@..@@....@@@@@
.@..@...@...@@@.@@@@
.@.@.@@.@.@.....@@@@
.....@.@.@..@@@...@@
.@.@......@....@@.@@
.@.@.@.@.@@.@.@@....
..@@@...@....@@@@.@.
.@.@.@.@.@@.@@@@@@..
@............@@@@@@.
.@.@.@.@@.@.@@@@@@@@
.@@...@@@@..@@@@@@@@
..@@.@.@.@@.@@@@@@@@
@........@@@@@@@@@@@
..@.@.@@.@@@@@@@@@@@
@..@....@@@@@@@@@@@@
12
2 3 0
6 14 0
2 12 0
4 19 0
0 16 1
2 7 1
5 19 1
5 11 1
12 9 2
18 12 2
11 11 2
2 5 2

19 12 0
9 13 0
5 19 0
9 14 0
8 12 1
17 9 1
5 17 1
15 6 1
16 8 2
0 8 2
6 12 2
15 8 2
