width 20
height 20
@......@@@@@@@@@@@@@
@@.@.@..@@@@@@@@@@@@
@...@@@@@@@@@@@@@@@@
.@.@.@..@@@@@@@@.@@@
.......@.@@@@@@@..@@
@.@@.@...@@@@@@@@.@@
....@..@.@@@@..@...@
@@.@@@.@.....@..@.@.
......@..@.@..@...@.
.@.@.@@@.@@..@..@...
@@@..@@@@@@@...@@@.@
@@@@@@@@@@@@.@..@@@@
@@@@@@@@@.@@..@@@@@@
@@@@@@@@.....@@@@@@@
@@@@@@@@@.@.@@@@@@@@
@@@@@@@@@@@..@@@@@@@
@@@@@@@@@.@.@@@@@@@@
@@@@@@@@..@.@@@@@@@@
@@@@@@@@@....@@@@@@@
@@@@@@@@@@@.@@@@@@@@
12
10 7 0
12 8 0
8 9 0
9 17 0
8 6 1
14 11 1
7 1 1
1 6 1
16 8 2
15 9 2
10 18 2
14 7 2

8 8 0
15 7 0
7 8 0
16 6 0
6 3 1
1 6 1
11 13 1
1 0 1
10 8 2
9 12 2
4 3 2
3 0 2
