width 20
height 20
@@@@@@@@@@@@@@@@@@@@
@@@@@@@@@@@@@@@@@@@@
@@@@@.@@@@@@@@@@@@@@
@@@@...@@@@@@@@@@@@@
@@@.@.@.@@@@@@@@@@@@
@@.......@@@@@@@@@@@
.@.@@@.@..@@@@@@@@@@
.@..@@@..@@@@@@@@@@@
...@@@.@..@@@@@@@@@@
.@@@@@...@@@@@@@@@@@
.@@@.@@.@.@@@@@@@@@@
@@@.....@.@@@@@@@@@@
@@.@.@@....@@@@@@@@@
@....@.@.@..@@@@@@@@
..@.@...@.@@@@@@@@@@
@.@@..@...@.@@@@@@@@
.....@@@@.....@@@@@@
.@.@@@@@..@@.@@@@@@@
..@@@@@@.@@@@@@@@@@@
.@@@@@@@@@@@@@@@@@@@
12
2 8 0
6 13 0
7 10 0
12 17 0
9 12 1
6 5 1
9 8 1
4 16 1
0 17 2
10 16 2
0 16 2
2 13 2

8 8 0
2 5 0
9 12 0
6 6 0
9 8 1
5 5 1
11 13 1
9 6 1
2 6 2
10 16 2
0 18 2
0 8 2
