width 20
height 20
@@@@@@@@@@@@@@@@@@@@
@@@@@@@@@@@@@@@@@@@@
@@@@@@@@@@@@@@@@@@@@
@@@@@@@@@@@@@@@@@@@@
@@@@@@@@@@@@@@@@@@@@
@@@@@@@@@@@@@@@@@@@@
@@@@@@@@@@@@@@@@@@@@
@@@@@@@@@@@@@@@@@@@@
@@@@@@@@@@@@@@@@@@@@
@@@@@@@@@@@@@@@@@@.@
@@@@@@@@@@@@@@@@@...
@@@@@.@.@@@@@@@@@@.@
@@.@@....@@@@@@.@@..
@@.@.@.@.@@@@@...@@.
@....@.@...@...@....
@@.@....@@.@.@@@@.@@
@@@@.@.@@.@.@..@..@@
@@@@@...@....@..@...
@@@@@@@...@@@.@...@.
@@@@@@@.@.......@@@@
12
6 17 0
18 12 0
13 19 0
5 15 0
8 13 1
18 10 1
19 17 1
17 14 1
19 12 2
16 16 2
14 13 2
4 14 2

18 14 0
19 13 0
11 16 0
11 19 0
19 18 1
19 12 1
18 11 1
7 18 1
7 17 2
18 10 2
7 15 2
13 14 2
