width 20
height 20
@@..@.@...@@@@@@@@@@
.@@.....@@.@@@@@@@@@
....@@.@...@@@@@@@@@
.@@@@.@..@.@@@@@@@@@
........@@@@@@@@@@@@
@.@.@.@....@@@@@@@@@
@..@@..@@.@@@@@@@@@@
..@...@@...@@@@@@@@@
.@.@@.@@@@@@@@@@@@@@
...@..@@@@@@@@@@@@@@
@.@@@.@@@@@@@@@@@@@@
@@@.@.@@@@@@@@@@@@@@
@........@@@@@@@@@@@
@@@.@.@.@@@@@@@@@@@@
@@@..@..@@@@@@@@@@@@
@@@@@@.@@@@@@@@@@@@@
@@@@@@@@@@@@@@@@@@@@
@@@@@@@@@@@@@@@@@@@@
@@@@@@@@@@@@@@@@@@@@
@@@@@@@@@@@@@@@@@@@@
12
1 7 0
3 2 0
7 12 0
0 1 0
2 0 1
8 3 1
4 1 1
8 12 1
4 9 2
7 4 2
5 6 2
10 2 2

0 8 0
4 1 0
6 2 0
8 12 0
5 4 1
10 3 1
6 4 1
7 0 1
5 10 2
2 6 2
9 5 2
5 3 2
