width 20
height 20
@@@@@@@@@@@@@@@@@@@@
@@@@@@@@@@@@@@@@@@@@
@@@@@@@@@@@@@@@@@@@@
@@@@@@@@@@@@@@@@@@@@
@@@@@@@@@@@@@@@@@@@@
@@@@@@@@@@@@@@@@@@@@
@@@@@@@@@@@@@@@@@@@@
@@@@@@@@@@@@@@@@@@@@
.@@@@@@@@@@@@@@@@@@@
..@@@@@@@@@@@@@@@@@@
@.@@.@.@@@@@@@@@@@@@
........@@@@@.@@@@.@
.@.@.@@............@
..@@@.@@.@.@@.@.@.@@
.@.@@.@...@@@@@.@@.@
.......@.@@@@@.....@
.@@.@.@.@@@@@@@.@.@@
@@@@@....@@@@@...@.@
@.@.@.@@@@@@@..@....
......@@@@@@@@..@.@.
12
5 11 0
7 17 0
0 15 0
14 19 0
18 11 1
0 8 1
10 12 1
5 19 1
0 19 2
12 12 2
7 12 2
13 12 2

7 16 0
6 10 0
15 19 0
4 19 0
17 19 1
15 17 1
12 12 1
1 11 1
1 19 2
0 8 2
3 16 2
14 17 2
