width 20
height 20
@@@@@@@@@@@@@@@@@@@@
@@@@@@@@@@@@@@@@@@@@
@@@@@@@@@@@@@@@@@@@@
@@@@@@@@@@@@@@@@@.@.
@@@@@@@@@@@@@@@@....
@@@@@@@@@@@@@@@.@.@.
.@@@@@@@@@@@@@@...@.
..@@@@@@@@@@@@..@..@
@....@@..@..@.@@..@@
@@.@....@..@....@...
...@.@@@.@...@@...@@
@.@.@@.....@.@..@.@@
.......@@.@@@@@.@@@@
@@@@.@@....@@@@@@@@@
@.@@@@..@@..@@@@@@@@
@.....@...@@@@@@@@@@
..@.@...@.....@@@@@@
@..@@@@..@@.@.@@@@@@
..@@@@.@..@@@..@@@@@
@@@@@@...@@@@@.@@@@@
13
17 5 0
7 13 0
16 4 0
15 5 0
1 18 0
1 15 1
19 6 1
8 11 1
10 10 1
14 18 2
7 19 2
17 11 2
8 15 2

0 6 0
17 8 0
15 6 0
1 15 0
15 12 0
19 3 1
15 5 1
4 8 1
11 14 1
8 15 2
7 19 2
9 18 2
19 5 2
