width 20
height 20
@@@@@@@@@@.@.@@@@@@@
@@@.@@@@@@....@@@@@@
@@@..@@@@..@.@@@@@@@
....@@@@@@.@@@@@@@@@
@@.@@@@@@@....@@@@@@
....@@@@@..@.@@@@@@@
.@.@.@@@@.@@@@@@@@@@
.@....@@...@@@@@@@@@
@..@.@.@@.@@@@@@@@@@
@@@........@@@@@@@@@
@@@@.@.@.@@@@@@@@@@@
@@@@.@@.@@@@@@@@@@@@
@@@..@..@@@@@@@@@@@@
@@@@...@@@@@@@@@@@@@
@@@@@@@@@@@@@@@@@@@@
@@@@@@@@@@@@@@@@@@@@
@@@@@@@@@@@@@@@@@@@@
@@@@@@@@@@@@@@@@@@@@
@@@@@@@@@@@@@@@@@@@@
@@@@@@@@@@@@@@@@@@@@
13
3 3 0
3 2 0
10 1 0
9 9 0
8 7 0
4 11 1
9 8 1
0 7 1
12 4 1
12 0 2
2 8 2
0 3 2
12 1 2

12 4 0
3 7 0
9 5 0
3 12 0
7 9 0
6 9 1
8 9 1
12 1 1
12 5 1
4 9 2
10 9 2
3 3 2
9 9 2
