width 20
height 20
@@@@@@@@@@@@@@.@@@@@
@@@@@@@@@@@@@...@@@@
@@@@@@@@@@@.@@.@@@@@
@@@@@@@@@@.....@@@@@
@@@@@@@@@@@.@@..@.@@
@@@@@@@@@..@.@.@@...
@@@@@@@@..@@....@@@.
@@@@@@@@@....@.@....
@@@@@@@@.@.@.@@..@.@
@@@@@@@....@..@.@@@@
@@@@@@@@@.@@@.....@@
@@@@@@@@@...@@.@.@@@
@@@@@@@@..@@@@.@@@@@
@@@.@.@.@.@.....@@@@
@@@........@.@.@@@@@
@@..@@@.@.@@@....@.@
@@@@@@@@@@@@..@@...@
@@@@@@@@@@@@.@..@@..
@@@@@@@@@@@@@..@@@.@
@@@@@@@@@@@@@@......
13
9 9 0
3 13 0
17 19 0
13 9 0
3 15 0
14 19 1
9 11 1
14 5 1
13 10 1
7 15 2
6 14 2
13 15 2
14 18 2

10 5 0
9 7 0
11 2 0
4 14 0
18 17 0
12 13 1
14 18 1
11 4 1
13 10 1
8 14 2
10 7 2
18 18 2
17 7 2
