width 20
height 20
@............@....@@
@....@..@....@....@@
@.....@...@.......@@
.......@..........@.
.@..................
.......@...@..@.....
..@...@..@.....@....
@..........@........
@@@.................
...@.....@........@.
........@....@......
...@@.....@...@.....
......@...@.........
....@............@..
..........@.........
.....@........@.....
....@....@..@.......
.......@.......@....
..........@....@....
...................@
5
11 2 0
8 2 0
1 17 1
6 15 1
11 10 2

14 7 0
3 10 0
14 14 1
8 16 1
14 4 2
