width 20
height 20
........@@@.........
......@.@...........
...@................
....@......@.....@..
.........@...@..@...
........@...........
....@....@..........
........@......@....
.........@..........
............@.@.....
..@.................
.....@.....@........
.......@............
................@.@.
...@........@.......
.......@............
.....@..............
...........@..@.....
@@..................
...@..........@.@@@.
5
12 17 0
15 11 0
16 5 1
3 7 1
15 2 2

5 0 0
3 0 0
10 16 1
17 16 1
12 11 2
