width 20
height 20
..................@@
..................@@
......@....@.....@..
..............@.@...
...........@........
...@..........@.....
.............@......
.......@............
......@.....@....@..
...............@..@.
....................
...............@....
.................@..
@...........@..@....
....@.@...........@.
...........@@.......
.......@............
....@....@..........
...................@
.........@@.........
3
0 12 0
18 19 1
5 7 2

1 10 0
4 4 1
0 1 2
