width 20
height 20
..@@@@@@@@.@.@@.@.@@
.@.@@@@@@..........@
....@@.@..@@.@@.@.@.
@.@.@@..@..@...@@...
@@....@..@..@.@...@@
@.@@@...@..@...@.@@@
......@.@.@..@@@@.@@
@.@@.@@....@@@.@....
...@.@@@@.@......@.@
@.@@.@.@.@.@.@.@@@@.
@.@@@.........@..@@.
@..@.@.@.@.@.@@.@.@.
@@......@@..@.......
@@@.@@.@...@.@@.@.@.
@@@..@@@.@...@@..@..
@@..@@....@.@@..@.@.
@@@.@..@.@..@.@@@...
@@@@.@.@@@@.......@.
@@@@.......@@.@.@@.@
@@@..@.@.@.@@@@.....
7
7 6 0
14 15 0
5 10 0
18 7 0
19 14 0
11 1 0
6 18 0

11 4 0
18 18 0
19 7 0
10 0 0
4 7 0
19 14 0
6 19 0
