width 20
height 20
.@.@@.@@@...@@.@@...
...@...@@@.@......@@
.@...@.@@....@.@@...
@.@.@.@@@.@@@.@@.@.@
......@....@........
.@@.@.@@.@@@@.@@@.@.
.@@@...@.@@@....@@@.
@.@.@.@.....@@.@.@.@
..@.....@@@@.......@
@...@.@.@@@.@@.@.@..
..@..@@@@.......@..@
.@..@.@..@.@.@.@.@.@
.@@...@.@...@@.@....
..@.@...@@.@@@.@.@.@
@@@@@@.@@...@@@...@@
@.@.@.@@@@.@.@.@.@.@
.......@.@@.........
@.@@.@@.....@.@.@.@.
@@......@@.@@@...@..
@@@@.@.@@@@@@@@.@@@@
7
18 15 0
15 19 0
17 10 0
19 0 0
19 6 0
0 5 0
1 17 0

11 17 0
18 11 0
5 8 0
0 11 0
3 16 0
1 3 0
1 17 0
