width 20
height 20
@@@@@@@@@@@@@@.@.@.@
@@@@@@@@@@@@@.......
.@@@@@@@@@@@@@.@.@.@
..@@@@@@@@@@@@..@@@@
.@@@@@@@@@..@..@.@@@
..@@@@@@@..@@@....@@
@.@@@@@@@@....@.@...
...@@@@@@.@.@..@@@@.
@.@.@.@.@..@..@.@.@.
..@.......@.@.......
@.@.@.@.@.....@.@.@.
.....@@@..@@.@.@.@..
.@.@@@@@@.@.@......@
..@@.@@@@....@@.@.@@
@..@..@@@.@.@@@.@@.@
..@@.@@@@@..@@......
@..@..@@@@@@@@@.@.@.
@.@@.@@@@@@@@@@@@@@.
.....@@@@@@@@@@@@@@.
@.@.@@@@@@@@@@@@@@@@
7
1 18 0
11 12 0
7 8 0
1 3 0
17 15 0
10 10 0
2 12 0

9 7 0
14 2 0
1 19 0
14 5 0
10 4 0
19 17 0
15 12 0
