width 20
height 20
........@@........@@
.............@....@@
.......@......@.....
..@.......@.........
....@....@..@..@....
....................
..........@.........
.........@....@.....
...@................
..@........@.....@..
............@.......
.....@.......@......
........@...........
.@........@.........
...........@........
......@.............
.......@............
....................
................@...
....................
4
16 16 0
6 12 0
9 9 1
4 18 2

12 16 0
19 2 0
16 7 1
3 16 2
