width 20
height 20
@.........@@.......@
...................@
..........@..@.....@
....................
...@.@..........@...
...........@........
............@.......
.......@............
....@........@......
....................
................@...
...@.@..@....@......
....................
...............@....
........@..@.......@
....................
..@..@........@..@..
...@........@.......
....................
@@..................
4
12 2 0
8 10 0
18 2 1
7 18 2

9 18 0
2 9 0
7 18 1
1 6 2
