width 20
height 20
...................@
..........@.........
....@..@....@.......
..............@.....
....................
..@...@.....@.....@.
........@...........
...........@........
....@........@.@....
........@.@.........
.............@..@...
..@....@.@..........
.@..................
......@...@.........
.@...@.........@....
......@.....@.......
.@.....@.........@..
....................
.@..................
........@@..........
1
15 9 0

19 5 0
