width 20
height 20
@...................
@@.........@........
@............@......
.......@.......@.@..
........@.........@.
..............@.@...
.@..................
............@..@....
..@...@...@.........
....................
@.............@.@...
@........@.........@
@.@..@.....@..@.....
.......@.........@..
..@......@..........
.....@..............
..........@..@.@.@.@
..@..@.............@
.................@..
....................
1
18 9 0

1 19 0
