width 20
height 20
..@...@@@@@@@@@@@@@@
.@.@.@.@@.@@@@@@@@@@
...........@@@@@@@@@
.@@.@.@@.@@.@@@@@@@@
.@@@.@@......@@@@@@@
.@@@...@.@@@.@@@@@@@
@@@@@.@@..@....@@@@@
@@@@...@.@@@.@@@@@@@
@@@..@.@.@@@@.@@@@@@
@@@.@..@...@..@@@@@@
@@@.@@...@@.@...@.@.
@@@@@@@@.@@.@.@.....
@@@@@@@...@...@@.@@@
@@@@@@.@@.@.@.@.@@@@
@@@@@........@...@@@
@@@@@@.@.@.@.@.@@.@@
@@@@@@@...@.........
@@@@@@@@.@@@.@@@@@.@
@@@@@@@...@..@@@@..@
@@@@@@@@.@@@..@@..@@
11
8 2 0
5 2 0
14 15 0
3 8 0
11 11 1
12 14 1
19 10 1
17 19 1
7 12 2
3 9 2
14 6 2

8 2 0
15 13 0
8 11 0
3 8 0
4 1 1
0 3 1
15 10 1
14 15 1
13 11 2
9 18 2
7 10 2
