width 20
height 20
@@@@@@@@@.@@@@.....@
@@@@@@@@....@@@.@.@@
@@@@@@@@@.@@@@...@@@
@@@@@@@.@.@.@.@.@@.@
@@@@@...........@..@
@@@@.@.@@.@.@.@@@@..
@..@.....@@@..@.@..@
@.@@.@.@.@..@.....@@
...@.@@.@@@..@@@@..@
@.@..@..@@@.@@@@..@@
..@@.@.@@@.......@@@
@.@.@..@@..@.@.@.@@@
......@@.@..@...@..@
@.@@@......@.@@...@@
..@.@.@@@.@@..@@.@@@
@...@.@.@@.@.@.@.@@@
@@@..@.......@...@@@
@@..@..@.@.@...@.@@@
@@.@@@..@...@.@@@@@@
@@@....@@@@..@@@@@@@
11
16 11 0
12 4 0
13 6 0
18 3 0
17 12 1
12 6 1
8 6 1
16 10 1
16 0 2
9 3 2
4 12 2

4 19 0
2 8 0
13 6 0
1 7 0
3 11 1
12 6 1
6 13 1
17 8 1
18 6 2
18 3 2
4 9 2
