width 20
height 20
...@...@@@@.........
.......@@@@..@@.....
.......@@........@..
....................
..........@.@.......
........@.........@@
...@........@......@
..@.................
......@.....@......@
@......@.......@..@@
..@.............@.@@
......@..@.......@.@
..@..........@......
...@.@..............
....@....@..........
...........@...@....
..........@.........
..................@.
@......@.........@..
@@..................
14
12 14 0
18 11 0
1 11 0
16 15 0
3 10 0
18 16 1
6 18 1
17 16 1
1 1 1
3 9 1
4 9 2
13 10 2
11 12 2
19 16 2

6 5 0
19 12 0
1 14 0
0 5 0
14 16 0
16 2 1
10 11 1
1 2 1
0 12 1
11 0 1
11 18 2
17 0 2
17 7 2
1 1 2
