width 20
height 20
...................@
.......@............
....................
.......@......@.@.@.
.........@..........
..@.........@..@....
........@.@.........
.@@.................
.@@@.....@.@....@...
....................
..................@.
.....@........@.@...
....................
..@....@............
....................
...........@.@...@..
@.........@.........
@....@............@.
.......@............
....................
2
15 1 0
10 8 1

16 2 0
13 19 1
