width 20
height 20
@@.@.@.............@
@@.................@
@@..................
....@...........@...
.......@..@...@..@..
.@....@.............
................@.@.
...........@..@.....
.....@..............
....................
..........@..@......
@.......@......@....
.....@..............
............@.......
.....@..@....@......
...@....@.....@.....
....@..@@@........@@
............@.@.....
.......@.@..........
....................
2
6 10 0
15 5 1

0 17 0
18 7 1
