width 20
height 20
@@@@@...@.@..@@@@@@@
@@@@@@.@@.@@...@@@@@
@@@@@......@.@.@@@@@
.@.@@.@@.@....@@@@@@
........@@@.@..@@@@@
@@.@@@@..@@@..@@@@@@
...@.@.@.@@@@..@@@@@
@@...@....@.@@..@@@@
@@.@..@@@@....@@@@@@
@@.@.@.@.@@.@.@@@@@@
@.@....@....@..@@@@@
...@@@...@@@@.@@@@@@
.@.....@..@@..@@@@@@
.@.@@@@..@@@@@@@@@@@
@@.....@...@@@@@@@@@
@@.@.@.@.@@@@@@@@@@@
@..@..@....@@@@@@@@@
@@..@@@@.@@@@@@@@@@@
@@.@@@@@..@@@@@@@@@@
@@@@@@@@.@@@@@@@@@@@
11
8 17 0
5 8 0
2 3 0
2 8 0
0 13 1
3 12 1
5 4 1
9 14 1
13 10 2
3 17 2
4 15 2

4 7 0
14 6 0
10 10 0
6 0 0
2 12 1
2 8 1
4 16 1
6 4 1
8 6 2
6 2 2
11 4 2
