width 20
height 20
@@..................
@.....@.............
.........@.@.@..@...
......@.......@.@...
....@@....@.........
.....@@.........@...
.....@@.@@..........
@......@...@..@.....
......@.....@....@..
...@................
.........@..........
.....@....@......@..
........@...........
..............@.....
@...................
.........@.@.@..@...
....................
..@.@..............@
......@......@.....@
....................
6
3 5 0
18 5 0
2 5 1
15 17 1
5 0 2
7 10 2

12 19 0
17 2 0
2 12 1
18 19 1
9 1 2
18 17 2
