width 20
height 20
@@..................
....................
............@.......
...@......@.........
.@.........@..@.....
........@...........
....@...@....@......
.....@...@.......@..
.............@......
@..............@....
........@.@.....@...
.......@............
......@.............
@...@.......@.......
@@.@..........@.....
@.......@......@...@
....................
....................
..............@@..@.
...@................
6
14 5 0
18 4 0
14 13 1
6 18 1
9 14 2
1 19 2

13 5 0
17 6 0
16 13 1
2 2 1
9 13 2
11 10 2
