width 20
height 20
................@@..
....................
............@.......
......@.......@..@..
@...@...@.@.........
..............@.....
....@....@.......@..
......@.............
.............@.@....
..................@@
.@...@...@........@@
..@...............@@
........@@......@@@@
................@@@@
........@.......@@@@
.....@...........@@@
............@....@@@
.@.................@
....@...............
...................@
17
16 10 0
14 0 0
9 13 0
13 16 0
3 19 0
3 14 0
18 17 0
9 14 0
16 6 0
17 17 0
7 15 0
13 10 0
11 18 0
3 13 0
12 6 0
9 0 0
1 9 0

2 9 0
5 19 0
8 10 0
12 13 0
19 3 0
18 4 0
17 19 0
19 0 0
14 17 0
11 17 0
2 18 0
15 0 0
19 1 0
16 16 0
1 18 0
15 18 0
4 7 0
