width 20
height 20
@@@@@@@@.@@@@@@@@@@@
@@@@@@@...@.@@@@@@@@
.@@@@@.@@...@@@@@@@@
..@@...@.@.@.@@@@@@@
@..@.@.......@@@@@@@
@.@@..@.@@@.@@@@@@@@
....@.@@@@@..@@@@@@@
.@@@@..@@...@@@@@@@@
......@@@@.@@@@@@@@@
@.@.@.@@@@@@@@@@@@@@
@..@.@@@@@@@@@@@@@@@
.@...@@.@@@@@@@@@@@@
...@..@..@@@@@@@@@@@
.@@@.@@.@..@@@@@@@@@
@@........@@@.@@@@@@
@.@.@.@.@@@@@.@@@@@@
.....@..@@@.@.@@@@@@
.@@@@.@..@@...@@@@@@
.@..@.@.@@..@.@@@@@@
..@........@@..@@@@@
6
3 6 0
6 16 0
4 5 1
0 6 1
5 15 2
2 8 2

13 18 0
5 9 0
13 14 1
11 4 1
4 3 2
8 1 2
