width 20
height 20
@@@@@@@@@.@.@.....@@
@@@@@@@@.....@@@@.@@
@@@@@@@@@.@@..@@...@
@@@@@@@@@.@@@@@@.@.@
@@@@@@@@@..@@@@@@@.@
@@@@@@@@@.@@.@.@.@..
@@@@@@.............@
@@@....@.@@.@.@@.@..
@@@@.@.@...@@@@...@.
@@@@..@.@.@.@.@@.@..
@@...@..@.......@@@.
@@@@...@@.@@@.@.@@..
@@@@@.@.@@@@@@...@@.
@@@......@@@@@@@...@
@@@@@.@@.@@@@@@@.@@@
@@@@@@.@.@@@@@@@...@
@@@@@@...@@@@@@@.@..
@@@@@@@@..@@@@@.@@.@
@@@@@@@..@@@@@@.@@.@
@@@@@@@@.@@@@@@.....
6
13 9 0
7 13 0
18 2 1
9 6 1
9 10 2
18 16 2

11 1 0
16 8 0
14 0 1
16 7 1
15 18 2
5 11 2
