width 20
height 20
@@@@@@@@@@@@@@@@@@@@
@@@@@@@@@@@@@@@@@@@@
@@@@@@@@@@@@@@@@@@@@
@@@@@@@@@@@@@@@@@@@@
@@@@@@@@@@@@@@@@@@@@
@@@@@@@@@@@@@@@@@@@@
.@@...@@@@@@@@@@@@@@
..@.@@@@@@@@@@@@@@@@
.@...@@@@@@@@@@@@@@@
...@..@@@@@@@@@@@@@@
@@.@.@@@@@@@@@@@@@@@
....@.@@@...@@@@@@@@
@.@....@.@.@@@@@@@@@
@@@@.@......@.@@@@@@
@@....@.@.@.@.@@@@@@
@.@@.@@@@@@.@....@@@
........@.@@.@.@@@@@
@@.@.@@.........@@@@
@...@@@@.@.@.@@@@@@@
@@.@@@@@@@@....@@@@@
5
14 15 0
12 16 0
0 11 0
0 7 0
1 7 0

2 11 0
5 14 0
14 19 0
13 14 0
0 9 0
