width 20
height 20
.....@..............
............@..@....
...........@.....@..
...@................
..........@......@..
..................@.
..@..@........@.....
............@...@...
....@.@.@@..........
....................
.....@...@.....@....
@....@.......@......
@...................
..@.......@.@.......
...@..........@.@...
....@...............
.......@............
..................@@
.......@.....@....@@
....@.@@..........@@
12
15 14 0
2 16 0
8 5 0
11 0 0
14 12 1
18 15 1
1 15 1
4 3 1
4 18 2
15 16 2
18 3 2
3 17 2

7 8 0
3 15 0
2 7 0
9 19 0
1 3 1
15 0 1
14 1 1
17 18 1
14 18 2
13 14 2
12 4 2
10 9 2
