width 20
height 20
....................
.........@..........
@@@@................
@@@@................
@@@........@.....@..
@@....@...@...@.....
@@...@..............
............@@...@..
....................
..........@.......@@
.............@.@....
..@.@...@.........@.
....................
......@....@.....@..
...@..........@.....
.......@....@.......
..................@.
......@...@.........
.....@......@..@....
...................@
12
2 7 0
13 3 0
15 0 0
14 10 0
15 13 1
0 10 1
14 0 1
2 18 1
8 5 2
16 3 2
17 3 2
14 7 2

19 18 0
11 19 0
8 6 0
16 0 0
0 0 1
10 4 1
15 5 1
19 3 1
3 17 2
15 3 2
4 12 2
11 6 2
