width 20
height 20
....................
.......@....@.......
............@...@...
....@..............@
...@......@....@....
....................
....@...@.....@.....
........@.@.@....@..
...@.@.@@.@@..@.....
....................
.......@..@.........
....@..............@
.........@@@...@....
....................
........@...@.......
.....@........@..@..
....................
....@@...@..........
..........@..@......
....................
2
2 19 0
16 18 0

11 5 0
16 13 0
