width 20
height 20
@...........@@@@@@@@
@@.@@.@.@.@@.@@@@@@@
...@@@@@.......@@@@@
.@..@....@.@.@.@@@@@
@.@..@.@..@.@@..@@@@
....@@@.@.@....@.@@@
.@@.@.@.@@@@@@....@@
.@....@.@@....@.@..@
@.@.@.....@@@...@@..
@....@.@.@.@@@.@@@@@
@.@@@@@.....@@@@@@@@
.....@@@@.@@.@@@@@@@
@.@.@@....@..@@@@@@@
...@@@@@.@@.@@@@@@@@
@@..@@@.@@..@@@@@@@@
...@@@..@..@@@@@@@@@
.@.@...@@@.@@@@@@@@@
..@..@.....@@@@@@@@@
.@@@@..@@@@@@@@@@@@@
......@@@@@@@@@@@@@@
5
9 2 0
0 17 0
13 2 1
2 14 1
11 12 2

11 13 0
2 9 0
0 17 1
11 10 1
8 0 2
