width 40
height 40
..@...............................@.....
...........@............................
........@....@...@...@.@....@...@.......
..................................@@....
........@...........@............@......
........................................
...@................@............@..@...
........@@.....@.@......@...............
...........@........@..@..@.@.....@.....
..............@.......@...........@.@.@.
.@..@....@....................@.........
@.................@.....@.@..@......@...
@..@.....@.......@.......@..@....@......
@....@.......@....................@.....
..@.........@.@...@.....................
......................@.....@...........
...@....@.............................@.
............@...@.......@.@.........@...
..........@@...............@............
.......@......@.......@........@........
..@......@@.....................@.@.....
.....@....................@.............
.......................@................
............@.....@..@.......@..@...@...
.......................@...@............
...@.............@...........@..........
..............@................@......@@
....................@........@........@@
.....................@...@.............@
.@....@....@...@................@...@..@
..................@.@..@.....@..........
.........@...........@.........@..@.....
......................@..@..............
......@.............@...................
..@....@......................@.......@.
................@........@........@..@..
..@..........@...............@..........
...@.@.........@...@....................
...........@.....@..........@...........
@@......................@@.....@@.......
61
6 24 0
32 22 0
24 1 0
36 19 0
17 9 0
11 15 0
10 8 0
1 7 0
31 37 0
27 11 0
9 39 0
29 20 0
39 32 0
20 1 0
13 32 0
15 10 0
5 2 0
16 28 0
28 0 0
21 5 0
26 16 0
5 39 0
1 24 0
12 29 0
13 24 0
3 35 0
14 13 0
2 21 0
32 36 0
2 15 0
5 14 0
9 34 0
11 37 0
37 28 0
6 32 0
12 39 0
2 8 0
3 28 0
22 2 0
5 12 0
37 12 0
13 37 0
1 28 0
13 12 0
36 4 0
8 9 0
21 24 0
28 17 0
4 32 0
29 34 0
21 14 0
37 16 0
32 1 0
6 18 0
24 8 0
38 20 0
1 37 0
31 24 0
23 19 0
30 29 0
32 34 0

30 3 0
28 23 0
23 14 0
14 39 0
17 6 0
20 38 0
7 18 0
1 38 0
15 9 0
38 17 0
1 22 0
30 4 0
16 2 0
21 0 0
13 33 0
39 39 0
18 2 0
18 26 0
0 38 0
39 24 0
0 37 0
29 9 0
39 1 0
26 36 0
38 3 0
6 38 0
30 35 0
11 14 0
6 11 0
5 18 0
36 37 0
18 1 0
18 31 0
27 17 0
20 2 0
15 28 0
35 20 0
6 23 0
22 2 0
4 12 0
39 11 0
37 1 0
11 33 0
17 31 0
29 20 0
7 0 0
21 27 0
1 12 0
24 6 0
38 24 0
19 4 0
2 27 0
0 31 0
6 16 0
28 5 0
33 39 0
13 11 0
15 36 0
33 9 0
4 13 0
12 33 0
