width 20
height 20
...................@
................@...
.@.....@............
.....@........@.....
..........@.@.......
@..@..@..........@..
..............@.....
...@.....@.....@....
..@.................
......@..@.@.......@
.......@....@.......
......@...@......@..
............@...@...
.@..................
........@...........
.......@...@........
......@.............
....................
.......@............
...............@....
7
18 0 0
17 18 0
7 0 0
10 5 1
3 9 1
14 5 2
3 13 2

13 19 0
11 19 0
12 9 0
0 19 1
16 3 1
0 18 2
19 1 2
