width 20
height 20
@@@@@@@@@@@@@@@@@@@@
@@@@@@@@@@@@@@@.@@@@
@@@@@@@@@@@@@@@..@@@
@@@@@@@@@@@@@@@@.@..
@@@@@@@@@@@@@@@@...@
@@@@@@@@@@@@@@@@@@.@
@@@@@@@@@@@@@@@@@...
@@@@@@@@@@@@@@@@@@@.
@@@@@@@@@@@@@@@@@@..
@@@@@@@@@@@@@@@@...@
@@@@@@@@@@@@@...@@.@
@@@@@@@@@@@@..@.....
@@@@@@@@@@@@@..@.@.@
@@@@@@@@@@@@@@.@.@@.
@@@@@@@@@@@@...@@.@.
@@@@@@@@@@@@@@.@....
@@@@@@@@@@@.@....@.@
@@@@@@@@@@@...@.@@@@
@@@@@@@@@@..@.@..@@@
@@@@@@@@@@@..@..@@@@
8
19 14 0
16 2 0
14 19 0
19 15 1
18 3 1
17 15 1
17 9 2
15 17 2

11 17 0
17 4 0
18 11 0
14 19 1
19 7 1
15 10 1
11 19 2
14 13 2
