width 20
height 20
@.@.@@@@@@@..@.@@.@@
@....@@.@@@.@..@....
@@.@.@.......@.@.@@@
@..@..@@.@@@.......@
..@.@.@....@@@@@.@@.
@@@.....@.@@.@@@....
....@@.@@....@@@@@.@
.@.@.@@@..@@.@@@@@@@
.@@....@.@@@..@@@@@@
@@..@.@@@....@@@@@@@
@@@..@@@@@@.@@@@@@@@
@@@.@.@@@@....@@@@@@
@@@.......@@@..@@@@@
@@@@@.@.@@@...@@@@@@
@@@...@.@.@.@.@@@@@@
@@@@@.@...@@@.@@@@@@
@@@...@.@.@...@@@@@@
@@@@.@.@@@.@@..@@@@@
@@@......@....@@@@@@
@@@@.@@@...@.@@@@@@@
8
14 3 0
10 2 0
12 19 0
6 6 1
4 17 1
3 4 1
13 8 2
3 9 2

17 5 0
7 15 0
9 19 0
12 8 1
4 5 1
12 18 1
15 3 2
9 9 2
