width 20
height 20
@@@@@@@@@.....@...@@
@@@@@@@@@.@.@...@.@@
@@@@@@@@..@@@.@@@.@@
@@@@@@@@@..@@@@@@.@.
@@@@@@@@..@.@.@.....
@@@@@@@.@...@.@.@.@.
@@@.......@@.....@@.
@...@.@.@@.@@@.@@@..
@@@@@..@@...@...@.@.
@@@@@@...@.@.@.@....
@@@.@.@.@@.....@.@@.
..........@.@.@@@...
@@@@.@@.@..@@@@@.@.@
@@.....@@.@...@.....
@@@.@.@@..@.@@@@@@@.
@@@@@.@@@....@@@@...
@@@@@..@..@.@@@@@@@.
@@@@@@..@@.@@@@@@@..
@@@@@@@....@@@@@@@@.
@@@@@@@.@@.@@@@@@@@@
4
7 5 0
11 1 0
17 9 1
17 1 2

4 12 0
10 12 0
12 9 1
11 16 2
