width 20
height 20
@@@@@@@@@@@@@@@@@@@@
@@@@@@@@@@@@@@@@@@@@
@@@@@@@@@@@@@@@@@@@@
@@@@@@@@@@@@@@@@@@@@
@@@@@@@@@@@@@@@@@@@@
@@@@@@@@@@@@@@@@@@@@
@@@@@@@@@@@@@@@@@@@@
.@...@@@@@@@@@.@.@@@
..@.@@@@@@@@@@....@@
@...@@@@@@@.@@@@.@@@
..@@.@.@@@@.@@....@@
@.@.....@@@...@@.@@@
....@@.@.@@@.@@@...@
@@.@.......@..@..@@@
@@@@.@@.@@@..@@.@@.@
@@@@@@@.....@.@.....
@@@@@@@@.@.@..@.@@.@
@@@@@@@@@....@.@.@..
@@@@@@@@@@.@......@.
@@@@@@@@@...@@@.@...
4
9 17 0
10 18 0
3 7 1
14 18 2

16 17 0
16 10 0
15 10 1
14 17 2
