width 20
height 20
......@@@@.......@@@
...@.@...........@@@
........@........@@@
......@....@...@.@@@
.......@...........@
.@..................
..............@.....
...........@...@.@..
.....@..............
........@........@..
....................
....................
...@.....@...@@.....
.......@....@.......
.......@.......@....
....................
.@........@..@.@....
....................
....@...............
..............@@....
3
15 9 0
1 9 1
4 5 2

0 19 0
7 10 1
3 7 2
