width 20
height 20
....................
...@...@............
......@.............
.........@...@......
.......@........@...
........@...........
............@....@..
........@.@.........
...@................
......@@.......@....
.............@......
...............@....
................@...
.....@..@.....@.....
...@.......@.@......
....................
...@.......@...@....
.........@.....@....
...........@........
.....@..............
9
5 3 0
17 1 0
14 16 0
16 3 0
1 14 0
17 10 0
6 14 0
1 4 0
11 12 0

1 6 0
17 4 0
19 7 0
3 5 0
0 16 0
8 0 0
18 4 0
14 10 0
0 0 0
