width 20
height 20
@@..................
...........@........
..........@@........
.....@....@....@....
....................
...@................
....................
...........@........
....................
....@......@....@...
.................@..
....................
.......@...........@
...................@
..@...@........@....
............@....@..
..............@.....
....@....@.@........
.@............@.....
.@..................
9
12 8 0
0 8 0
19 18 0
9 15 0
12 19 0
7 17 0
18 14 0
11 3 0
14 17 0

3 19 0
18 10 0
15 18 0
16 17 0
19 17 0
18 3 0
3 15 0
11 6 0
6 7 0
