width 20
height 20
@.............@.....
...@..........@...@.
..@.................
...@.....@..........
..@@.@....@.........
....@.............@.
........@.@..@......
....@...............
...@.....@.@........
...............@....
..............@.....
...........@....@...
....................
...@..@.@..@...@....
.@.................@
.........@@.......@.
......@..........@..
....@...............
..@................@
...................@
7
10 14 0
8 17 0
15 6 0
10 7 1
5 7 1
18 3 2
3 12 2

6 19 0
0 10 0
15 1 0
8 5 1
3 11 1
18 2 2
19 0 2
