width 20
height 20
...@@@@.@.@......@.@
....................
.....@...@...@......
....................
....................
............@..@....
..@.@...............
.@.......@...@......
......@..........@..
....@.......@.......
.@............@.....
.........@...@......
....................
.....@.......@...@..
..........@.........
...............@....
.....@.@.@..........
...@...........@....
....................
.........@.........@
7
19 16 0
2 18 0
10 4 0
1 17 1
2 16 1
5 15 2
18 0 2

3 18 0
11 18 0
10 4 0
6 17 1
0 18 1
4 14 2
10 19 2
