width 20
height 20
..............@@....
.....@..@.......@...
....................
..............@..@..
@.@..........@..@...
@...........@.....@.
@.............@.....
...............@....
@....@..@...@.....@.
....................
.....@..@.@....@....
................@...
....................
......@.............
.@...@.@....@....@.@
...@.....@...@......
.@....@.@...........
.....@.......@......
.....@@.............
....@@@......@..@...
6
9 6 0
8 17 0
9 5 1
15 1 1
7 17 2
2 12 2

13 7 0
19 0 0
18 1 1
1 18 1
19 3 2
3 7 2
