width 20
height 20
.....@...@..........
.................@..
.............@......
.....@...........@..
............@.......
.....@....@.........
....@........@....@@
.......@.@........@@
.............@..@...
.......@....@......@
..@.................
.........@..........
@...@.@......@......
@.................@.
@.....@....@.......@
...@........@.......
..............@.@..@
.....@.........@..@@
...@@.....@.......@@
..................@@
6
1 18 0
8 12 0
13 3 1
4 10 1
15 14 2
0 17 2

3 17 0
18 0 0
10 15 1
15 10 1
0 6 2
7 19 2
