width 20
height 20
...........@.....@@.
.........@@@........
.........@..........
@...............@...
...@@....@..........
.@............@.....
.........@......@.@.
.....@.......@......
.@.@......@.........
...........@........
......@.@...........
...@...........@....
...........@.@......
..............@.....
....................
.........@.....@....
......@.@..@.....@..
..............@.....
...........@........
........@.@@..@@....
6
9 9 0
6 12 0
8 8 1
2 4 1
11 14 2
12 3 2

5 9 0
3 13 0
4 19 1
9 16 1
19 3 2
1 17 2
