width 20
height 20
@@..................
...@@.....@.........
..@@..@.............
@.@......@..........
....................
.............@...@..
......@..@..........
..@.............@.@.
.............@......
....................
..@....@......@...@.
....................
...........@........
@...@....@..@..@....
@...@@..............
...........@.@......
.@..................
...@........@.@..@..
....@@.........@....
.....@..............
11
6 0 0
18 17 0
8 17 0
13 19 0
7 7 1
0 9 1
10 12 1
16 9 1
5 15 2
6 8 2
15 19 2

10 2 0
7 5 0
2 19 0
2 18 0
7 7 1
18 9 1
11 13 1
5 15 1
5 16 2
17 15 2
3 4 2
