width 20
height 20
......@.............
...........@........
@.......@........@..
@.........@.....@...
.....@....@....@....
..............@.....
...@.@.@.........@..
........@.....@.....
.@..@........@......
............@.@.....
...@................
.......@@.........@.
......@@@.@.........
@...@.@@............
............@.......
....................
@....@....@.....@...
@.....@.............
@...................
@@@.................
11
18 15 0
5 19 0
10 14 0
18 13 0
18 18 1
18 5 1
8 5 1
15 6 1
5 0 2
11 8 2
4 1 2

14 13 0
2 14 0
19 0 0
14 12 0
1 14 1
10 6 1
8 3 1
9 11 1
14 18 2
1 15 2
8 17 2
