width 20
height 20
.....@..............
....................
............@.@.....
.......@.@.@...@....
..........@.........
...@................
...................@
..........@.........
.......@...@..@.....
......@.@........@..
...................@
@@@@..@.........@...
@@@@......@.........
@@@@....@...........
@@@@.........@...@..
@@@@@@@@....@.......
@@@@@@@@...@........
@@@@..@.............
@@@........@........
@@@..@@@............
13
3 3 0
8 14 0
8 4 0
7 10 0
10 18 0
15 5 0
8 11 0
12 19 0
19 17 0
13 11 0
5 7 0
12 0 0
3 9 0

5 3 0
6 4 0
8 3 0
15 2 0
16 12 0
13 5 0
16 8 0
18 3 0
9 12 0
13 6 0
16 19 0
5 18 0
3 3 0
