width 20
height 20
....................
................@...
..@.................
@..@....@...........
@.........@......@..
.....@..............
...........@........
@@..................
@@....@........@....
@@............@@@...
@.......@...........
@...................
....................
.................@..
....................
.....@@.@....@..@...
...@..@.....@.......
..................@@
@...@....@..........
@...................
13
2 15 0
2 1 0
13 16 0
10 6 0
17 12 0
12 17 0
8 4 0
4 9 0
7 0 0
16 11 0
11 10 0
19 8 0
1 16 0

3 9 0
16 14 0
0 0 0
6 18 0
1 2 0
17 2 0
4 19 0
19 2 0
2 6 0
2 0 0
2 8 0
12 6 0
2 16 0
