width 20
height 20
@@..@.@@@@@@@@@@.@@@
@.@.@..@@@@@@.@@.@@@
@.....@@@@@@.....@@@
..@.@@.@@@..@.@@...@
@@.......@@....@@@..
...@.@.@....@.@@@..@
.@..@@..@.@..@.@.@..
..@@...@.@@@@......@
.@...@......@@.@@.@@
@@@.@.@.@@.@@@...@@@
@@.....@@@..@@@.@@@@
@@@.@@.@@@@@@@@@@@@@
@@..@@@@@@@@@@@@@@@@
@.@..@@@@@@@@@@@@@@@
....@@@@@@@@@@@@@@@@
@.@.@@@@@@@@@@@@@@@@
@@@@@@@@@@@@@@@@@@@@
@@@@@@@@@@@@@@@@@@@@
@@@@@@@@@@@@@@@@@@@@
@@@@@@@@@@@@@@@@@@@@
18
1 7 0
11 4 0
1 14 0
0 6 0
14 6 0
3 2 0
7 8 0
13 3 0
3 1 0
4 2 0
14 9 0
6 3 0
5 7 0
18 6 0
3 9 0
12 2 0
4 13 0
0 14 0

17 7 0
10 3 0
3 14 0
14 9 0
9 6 0
16 3 0
4 10 0
4 4 0
9 8 0
1 14 0
3 12 0
11 10 0
12 4 0
13 4 0
7 8 0
12 6 0
3 2 0
15 9 0
