width 20
height 20
@......@@@@@@@@@@@@@
@@.@.@.@@@@@@@@@@.@.
@@.@.@@.@@@@.@@@....
@@@...@..@....@@@.@@
@@@@.@.@.@.@.@@@@.@@
@@@@........@@@@...@
@@@@.@@@@@@..@@..@..
@@@@@@......@@..@.@@
@@@@.@.@.@@.@.@....@
@@@@...@@.@...@@@.@.
@@@..@..@.@.@.......
@@@@..@....@..@@@.@.
@@@@@.@.@.@..@@@@@..
@@@@@@...@@@@@@@@@@.
@@@@@@@.@@@@@@@@@@@@
@@@@@@@@@@@@@@@@@@@@
@@@@@@@@@@@@@@@@@@@@
@@@@@@@@@@@@@@@@@@@@
@@@@@@@@@@@@@@@@@@@@
@@@@@@@@@@@@@@@@@@@@
18
7 3 0
15 7 0
16 6 0
6 5 0
6 0 0
12 11 0
19 11 0
4 8 0
6 13 0
10 4 0
9 7 0
4 11 0
10 7 0
4 2 0
11 12 0
19 13 0
17 9 0
5 5 0

15 6 0
19 6 0
2 2 0
8 4 0
9 5 0
4 11 0
18 12 0
14 7 0
7 7 0
16 2 0
17 1 0
3 10 0
11 8 0
13 9 0
2 1 0
13 10 0
5 0 0
16 6 0
