width 40
height 40
@@@.....@........@@.....................
@@@..........@..........................
@@@.@..................@@.........@.....
@@@...@......@....@...@...@....@........
@@.@.............@...................@..
.....@........@.........@..........@....
...@.............@........@...@.........
................@.@...@.........@...@...
..............@.........................
...................@.............@......
.....@......@.@......@..................
...........@...@...@....................
..........................@........@....
@...@....@..@.@........@.....@..@.......
...@............@...@.@.......@.....@...
........@.................@......@......
...........@......@.....@............@..
.........@.............@...@............
.............................@...@......
@......@................................
...@..@.....@.@................@....@...
..@.@.................@......@...@......
.........@.@.....@.@....................
....@..@...............@.......@.@.@..@.
...........................@............
......@................@@...@...@.......
..@.................@...@...............
............@..@........@........@......
@..@.@...............@..................
........@..........@..@.@....@..@....@..
......@...@.........@.........@.....@...
@...........@.....................@..@..
@..@...........@......@................@
..@.....@...............@.@@....@......@
............@.@.@....@.....@..@...@..@..
.....@..................@...............
..@.......@....................@..@.....
.@.............@.......................@
.....@.................................@
.......................@@...........@...
10
14 27 0
13 19 0
33 0 0
13 13 0
38 5 0
11 7 0
23 37 0
31 12 0
8 18 0
24 24 0

39 21 0
36 22 0
34 3 0
37 36 0
11 34 0
18 2 0
30 17 0
8 26 0
27 37 0
15 19 0
