width 20
height 20
@@@.....@@@.........
@@..............@...
@@..................
...........@........
.......@..@.........
......@.....@...@.@.
....................
......@...@..@......
.................@..
..............@....@
........@...........
......@........@....
.....@..............
...@....@...........
..........@..@.@.@@@
.....@.............@
....@..@.@..........
.................@..
......@.............
.@......@@..........
8
11 8 0
16 19 0
19 16 0
2 9 1
4 0 1
11 5 1
16 16 2
2 14 2

5 19 0
12 7 0
3 4 0
0 5 1
5 16 1
0 18 1
2 2 2
2 18 2
