width 20
height 20
....................
.......@......@.....
............@.......
.@...........@......
....@..@.@..........
..........@.@.......
....................
....@......@........
.@......@@....@.....
........@@@.........
........@@..@.@.@.@.
...........@.@......
.@.@......@.......@.
.............@..@...
....@..........@...@
....................
@@............@.....
.....@.@.@......@...
....................
....................
8
13 7 0
6 13 0
10 19 0
10 14 1
9 1 1
3 17 1
8 4 2
10 13 2

2 7 0
13 0 0
7 12 0
15 12 1
11 6 1
5 10 1
4 18 2
11 8 2
