width 20
height 20
.@...@............@@
...@..@.@.@@.@@@.@@@
@.@@@...@.@.@.@.@@@@
..@...@..@.......@@@
@..@@..@..@.@.@.@.@.
..@.@.@.@@.@.@......
@...@........@.@@.@.
@.@..@.@.@@@..@@@@..
@@..@..@@..@.@.@..@.
@@@..@@...@....@.@..
@@@@@@@@.@.@.@.@.@@.
@@@@@@@.....@.......
@@@.@.@@.@@...@.@.@.
@.....@@..@.@..@...@
@.@.@....@@..@.@@.@@
...@@@@@.@..@.@@...@
@.@.@.@..@@....@@@..
@......@@...@.@@@@@.
@.@.@.@.@@.@...@@@@@
@.@@.....@@@@.@@@@@@
13
0 5 0
15 4 0
17 15 0
3 7 0
8 3 0
19 7 1
14 9 1
5 17 1
11 6 1
17 5 2
8 12 2
5 14 2
15 5 2

1 5 0
3 5 0
19 10 0
11 17 0
10 6 0
9 2 1
13 18 1
8 10 1
8 3 1
19 9 2
13 12 2
10 10 2
6 4 2
