width 20
height 20
@@.............@....
.@..@..........@....
........@...........
....@@..............
...............@....
..@@..@......@...@..
...........@..@...@.
...@..@.@...........
@......@.......@..@.
....................
.@.@.......@........
.......@............
....@...............
...................@
...@...@.@.........@
.............@.@....
..@...@..@..........
....................
.............@@..@..
...@@........@@.....
15
9 13 0
4 13 0
18 17 0
9 9 0
16 1 0
16 4 1
15 2 1
9 5 1
7 3 1
6 3 1
2 7 2
7 5 2
10 19 2
18 1 2
10 10 2

7 3 0
16 14 0
18 17 0
16 10 0
0 19 0
1 12 1
7 19 1
14 12 1
5 15 1
8 1 1
17 13 2
19 16 2
13 3 2
10 3 2
10 14 2
