width 20
height 20
@.@@@@.@...@@@@.@.@@
@.@.@....@@@@@......
....@.@@..@.@.@.@@@@
@.@@.@.@.@..........
...@.@....@.@.@.@@@.
.@.....@.@@.@.@@@@..
..@.@.@@@...@@.....@
.@@@......@@@.@.@.@.
.@..@@@@.@.@...@..@.
..@.........@.@.@...
.@@.@@.@.@.@..@.@.@.
@.@..@..@@@.@....@..
@...@@@.....@@.@@.@.
..@@.@.@@@@.@.......
.@.....@@..@@.@@@@.@
.@.@@@....@@.@@@@...
.....@@@@..@..@@@@.@
@.@@.@.@..@.@..@@@..
@..@@@.@@.@...@@@@@@
..@@@@......@.@@@@@@
14
14 11 0
2 18 0
8 15 0
16 13 0
9 15 0
18 13 1
6 18 1
10 9 1
1 18 1
15 13 1
3 10 2
10 19 2
6 3 2
19 12 2

8 7 0
1 18 0
19 8 0
19 4 0
17 6 0
4 11 1
4 16 1
3 12 1
19 13 1
15 2 1
19 12 2
6 13 2
13 5 2
15 4 2
