width 20
height 20
@@@@@@@@@@@@@..@@@@@
@@@@@@@@@..@..@.@.@@
@@@@@@@@@.@.@.@.....
@@@@@@@@........@.@.
@@@@@@@.@.@.@.@..@..
@@@@@@.....@.@@@@..@
@@@@@.@.@.@....@.@.@
@@@.....@@@.@.@.....
@@@@.@@.@..@@.@@.@.@
@.@...@@.@......@...
...@@......@.@.@.@.@
@.@...@.@.@.@@.@....
...@@@@@....@@@@.@@@
@@.@.@@..@.@@@.@....
@@...@.@@@@@@....@@@
@@.@...@.@.@.@.@@@.@
@.@..@.............@
@.@@.@@.@.@.@.@@.@..
......@..@...@@@@..@
@@.@.@@@@@@.@@@@@@..
14
7 6 0
16 13 0
14 14 0
13 4 0
19 7 0
2 10 1
6 14 1
18 2 1
18 10 1
2 13 1
4 9 2
8 3 2
6 7 2
10 16 2

16 13 0
0 12 0
8 9 0
13 4 0
11 6 0
7 11 1
17 2 1
2 19 1
12 10 1
12 15 1
19 13 2
7 8 2
4 17 2
13 0 2
