width 20
height 20
@........@@@.......@
.................@@@
..............@..@@@
.....@...........@@@
.........@.......@@@
....@.@.@........@@@
...@...@.....@.....@
..........@.........
.................@.@
.......@...@..@....@
..@..@.......@.....@
.@.......@..........
......@.............
.@...@..........@...
......@.......@.....
.................@.@
@......@.....@......
...@..@.............
....................
..................@.
7
19 11 0
13 12 0
9 15 0
10 17 0
8 9 0
12 12 0
7 10 0

4 0 0
5 8 0
0 1 0
7 0 0
8 8 0
0 6 0
19 19 0
