width 20
height 20
...@.@........@.@.@.
.@...@.@.@.@@.@.@.@.
@.@@.@@...@@@.......
.......@.@@...@@@@@@
.@@@.@@..@.@@...@..@
.@...@@.@.....@.@@..
..@.@@.@.@.@@..@@..@
@@.........@.@@..@..
@@.@.@.@.@@..@.@.@.@
@...@..@@@@@........
.@.@.@@@@@@.@.@.@.@.
........@@...@.@@@..
@@@@.@@..@@@.@..@.@.
..@...@.@@@@..@.@...
@...@.@.@@@..@....@.
..@@.@.@.@.@.@@.@..@
@................@@@
@@.@.@.@@.@.@.@.@@@@
@@@...@@@..@..@@@@@@
@@@@.@@@..@@@..@@@@@
12
14 8 0
2 14 0
0 11 0
17 12 0
1 14 1
1 13 1
5 16 1
3 13 1
7 11 2
11 16 2
7 16 2
13 3 2

4 3 0
15 7 0
10 6 0
3 7 0
13 19 1
17 13 1
18 13 1
17 10 1
2 16 2
6 0 2
14 11 2
9 5 2
