width 20
height 20
.@..@..@@@@..@..@@..
..@.@.@@@@..@.@.@.@.
@......@@.@.......@.
@.@@@@@.@...@.@.@...
@.........@@.@.@.@.@
.@.@.@@@@.@....@....
..@@@@.@@...@@.@.@@@
.@.@.@..@.@..@..@...
.@.....@...@.@.@.@.@
.@.@.@.@@.@@@.......
...@@.@.@@@@..@@@.@.
.@......@.@.@.@@@@..
@..@.@.@......@@@@@.
.@@@@....@.@.@@@@...
.@.@.@.@@@@.@.@@@.@.
......@@@@@......@@.
@@.@@..@@@@.@.@.@.@.
...@@@.@@.@..@@@@...
@@.@@.@...@.@.@.@.@.
@@......@..........@
7
5 13 0
10 6 0
1 10 0
6 4 1
17 3 1
17 7 2
13 12 2

19 11 0
5 18 0
13 10 0
1 10 1
0 8 1
12 13 2
6 12 2
