width 20
height 20
@....@...@@@.@..@.@@
@@@@.@.@..@...@.....
........@..@@...@@.@
.@.@.@.@..@@..@@..@.
..@@@...@...@.@.@...
.@@@.@.@.@@.@.....@.
@@@......@.@..@.@@..
@@.@.@.@.....@.@.@.@
......@.@.@.@.......
.@.@.@...@.@@.@.@@@@
.@.@@.@.@..@@@@@...@
@.........@@@@.@.@.@
@@.@.@@.@...@..@@...
@@@@@@@@..@@.@.@.@.@
@@.@.@@.@...........
@.........@@.@.@.@.@
@@.@.@.@.@....@@@..@
@@.@@@.@@..@.@@@..@.
.....@@@.@..@@@@@...
@@.@@@.....@@@@@@@.@
7
5 2 0
2 12 0
4 7 0
6 4 1
10 18 1
13 4 2
7 15 2

7 4 0
2 12 0
11 7 0
13 16 1
10 18 1
18 16 2
19 8 2
