width 20
height 20
@@@@@@@@@@.@..@.@.@@
@@@@@.@@@..@@......@
@@@@.....@....@@.@.@
@@@@.@@.@@@.@.@@@@..
@.@..@..@@...@.@.@@@
....@.@...@.@.......
.@.@....@@....@.@@.@
@..@@@@...@.@@@@....
..@.@.@.@@.@.@@@.@.@
@@............@..@.@
.@@.@.@@.@.@.@@.@@@.
....@@..@...@@......
@.@.@@@.@@.@@.@.@.@.
.@......@@@@...@@..@
..@@@.@..@.@@.@@..@.
@.@....@........@...
....@.@.@.@.@.@...@@
.@.@.@....@..@..@...
..@@.@.@@..@..@..@.@
@.....@...@@.@..@..@
7
8 2 0
15 11 0
7 13 0
12 13 1
6 18 1
8 14 2
7 12 2

8 17 0
9 9 0
4 19 0
13 15 1
0 16 1
11 2 2
13 16 2
