width 20
height 20
...................@
...................@
...................@
..@.................
....@.@.@.@..@.....@
.......@.........@@@
...............@@@@@
..@.........@..@@@@@
..........@.....@@@@
....@...............
...@...@....@.......
....................
......@.....@.......
................@...
...@......@.........
.....@.........@....
...@.............@..
....................
@@.....@.@.......@@@
@@................@@
8
17 0 0
14 10 0
1 16 0
9 15 0
13 9 0
3 9 0
6 15 0
3 13 0

8 9 0
16 10 0
17 4 0
15 18 0
14 9 0
18 10 0
1 1 0
15 2 0
