width 20
height 20
....................
....................
.@....@..@..@.......
....@...............
.............@......
.....@..............
.........@..@..@....
...@.......@........
....................
................@...
......@......@......
..@.................
....................
.....@..............
..@...@....@.@.....@
..............@.....
.......@............
@@@@@...............
@@@@@.......@.....@.
@@@@@@..............
8
12 12 0
14 6 0
7 18 0
16 17 0
8 19 0
11 9 0
18 2 0
10 8 0

0 1 0
0 4 0
9 9 0
1 16 0
9 16 0
13 16 0
0 15 0
5 11 0
