width 20
height 20
@@@@@@@@@@@@@@@@@@@@
@@@@@@@@@@@@@@@@@@@@
@@@@@@@@@@@@@@@@@@@@
@@@@@@@@@@@@@@@@@@@@
@@@@@@@@@@@@@@@@@@@@
@@@@@@@@@@@@@@@@@@@@
@@@@@@@@@@@@@@@@@@@@
@@@@@@@@@@@@@@@@@@@@
@@@@..@@@@@@@@@.@@@@
@@@@@....@@@@@..@@@@
@.@.@.@@@.@@@@@.....
...........@@@@@.@@.
.@@.@.@@@.@.@@@.@@..
...@@.@.........@.@.
.@..@.@@.@.@.@@...@.
@@.@..@@@@@..@@.@.@.
@@..@@@@@@@@.@@@@...
@..@@@@@@@@@@@@@..@.
@@..@@@@@@@@@@@@@@@.
@@.@@@@@@@@@@@@@@@@.
14
5 11 0
17 17 0
3 16 0
9 11 0
19 11 0
12 16 1
9 12 1
15 10 1
2 15 1
2 16 1
3 18 2
19 13 2
0 14 2
16 14 2

19 12 0
17 16 0
15 15 0
15 13 0
4 11 0
7 13 1
15 8 1
2 14 1
11 13 1
10 13 1
17 17 2
2 19 2
12 14 2
13 13 2
