width 20
height 20
@..@...@......@@@@.@
@.@.@.@..@@@.@@@.@..
........@.....@@...@
@@.@@.@..@.@@@.@.@..
.....@..@.......@..@
@@@.@@.@..@.@@.@@@..
@@@.@@..@.@@....@..@
@@@@@@@..@@@@@@.@.@.
@@@@@@@@@@@@@@......
@@@@@@@@@@@@@@@.@.@@
@@@@@@@@@@@@@@@..@@@
@@@@@@@@@@@@@@@@@@@@
@@@@@@@@@@@@@@@@@@@@
@@@@@@@@@@@@@@@@@@@@
@@@@@@@@@@@@@@@@@@@@
@@@@@@@@@@@@@@@@@@@@
@@@@@@@@@@@@@@@@@@@@
@@@@@@@@@@@@@@@@@@@@
@@@@@@@@@@@@@@@@@@@@
@@@@@@@@@@@@@@@@@@@@
14
1 1 0
3 6 0
17 8 0
3 1 0
11 0 0
7 1 1
0 2 1
15 6 1
2 3 1
18 1 1
18 8 2
4 4 2
10 0 2
17 9 2

2 2 0
6 4 0
13 0 0
16 1 0
16 2 0
14 3 1
8 3 1
5 2 1
18 5 1
8 1 1
10 0 2
17 6 2
19 1 2
7 2 2
