width 20
height 20
@............@@@...@
@..@................
@......@..@.........
@........@..........
....................
....................
..........@@........
@@...........@......
@@...@............@@
..@.....@.......@...
....@.@...@....@....
....................
.@.........@........
.....@...@..@.......
...........@........
....................
.@...........@...@..
....................
.....@..............
......@............@
9
0 6 0
13 9 0
10 7 0
0 17 1
8 12 1
3 0 1
1 3 2
14 13 2
4 16 2

14 14 0
12 9 0
3 15 0
3 19 1
18 17 1
11 17 1
12 7 2
18 2 2
17 4 2
