width 35
height 35
..@.........................@...@..
...................................
........................@........@@
..............@......@.......@...@@
.................@.@...............
..@.......@.....................@.@
@......@....@....@....@..........@@
@.......@........................@@
@.@.@@.....@.@.@.@.@...@....@.@....
..........................@........
...................................
............@...@.....@........@...
.....@...............@.............
.@....@..@..@...@...@.....@.....@..
...@..........@....................
..........@........................
............@.................@.@..
.......@...........................
.....@...@.........@...............
.@.@..........@........@...........
....................@......@.......
..@........@.@.....@.....@...@.....
.......@......@..@..@..............
.@......@.......@..@.@.@.....@.....
............@......................
....@.........@....@...............
.............@......@...@..........
....@.....@.......@..........@.....
..........................@........
...............@....@..@.@..@......
...................................
..@.....@...................@......
....@@...........@...@..@..........
@.@@@@.....@@......................
@@@@@@.....@@......................
36
34 12 0
12 17 0
17 33 0
8 24 0
32 22 0
12 2 0
13 18 1
27 15 1
30 19 1
2 14 1
5 5 1
17 0 1
12 9 2
29 0 2
31 31 2
4 4 2
11 23 2
34 9 2
16 17 3
31 14 3
21 8 3
26 0 3
19 16 3
6 16 3
7 3 4
33 22 4
0 2 4
10 19 4
25 23 4
33 26 4
26 25 5
19 6 5
13 30 5
17 26 5
28 28 5
17 10 5

21 33 0
0 20 0
18 14 0
25 26 0
23 2 0
21 6 0
16 27 1
30 6 1
22 27 1
1 14 1
20 33 1
34 10 1
1 8 2
33 32 2
29 22 2
1 29 2
25 5 2
34 1 2
30 18 3
1 10 3
21 19 3
24 14 3
23 12 3
5 25 3
1 2 4
32 23 4
1 4 4
5 23 4
20 31 4
6 1 4
4 24 5
18 6 5
3 29 5
16 33 5
24 16 5
26 20 5
