width 20
height 20
@@@@@@@@@@@@@@@.@..@
@@@@@@@@@@@@@@@...@@
@@@@@@@@@@@@@@@.@..@
@@@@@@@@@@@@.@.@@.@@
@@@@@@@@@@@....@..@@
@@@@@@@@@...@@..@.@@
@@@@@@@@@@@..@@.....
@@@@@@@@@@@@...@@.@.
@@@@@@@@@@@@.@..@.@.
@@@@@@.@@@@@@@@@..@.
@@@@@...@@@@@@.@@..@
@.@@@@@.@@.@......@.
...@@@.......@@.@...
.@@@@@@@@.@@.@.@..@.
.@.@@@@@.@@....@@.@@
...@.@@....@.@..@..@
.@.....@.@@.@@.@..@@
..@@.@..........@.@@
.@.@..@.@@.@.@.@@.@@
....@@@.@@.@@@@@@@@@
1
11 4 0

17 12 0
