width 20
height 20
@...@@@@@..@@@@@@@@@
..@.@@@@..@.@@@.@@@@
.@.@.@.@@........@@@
........@.@@.@.@...@
.@.@.@.@.@.@.@.@.@.@
@...@@......@.@@@..@
.@.@@.@.@@@.......@@
...@.....@.@.@@.@..@
@.@@@.@.@@...@@@@@.@
....@..@@.@.@@@@@@..
@@.@@.@@@.@.@@@@@@@.
..@@@@@.@.@....@@@@@
.@.@@.......@@.@@@@@
.@.@@@.@@.@.@@@@@@@@
...@@@...@.@@@@@@@@@
.@.....@...@@@@@@@@@
.@@.@.@@@.@@@@@@@@@@
...@@@@@@@@@@@@@@@@@
.@@@@@@@@@@@@@@@@@@@
...@@@@@@@@@@@@@@@@@
1
8 4 0

1 19 0
