width 20
height 20
@@@@@@@@@@@@@@@@@@.@
@@@@@.@@@@...@@@@...
@@@@@.....@.@.@@.@.@
@@@@..@@.@....@.....
@@@@@...@@.@@...@.@@
@@@@@@@.@.@..@.@.@@.
@@@@@.....@@........
@@@@..@@@@@..@.@.@.@
@.@.@.@@@@@.@@@@@@..
.......@..@...@@@..@
.@.@.@@..@.@.@.@@@..
..@@@@.@...@...@...@
.@.@.....@.@@@.@.@..
...@.@.@@@@@.@.@..@@
@@.@@..@........@..@
...@.@..@.@@.@.@..@@
@.@...@.@.@...@@@...
....@@@.@..@.@@@@@.@
@.@.......@..@@@@@..
@@@@.@.@.@@@.@@@@@@.
7
13 4 0
4 16 0
4 10 0
13 11 1
18 11 1
5 14 2
7 18 2

8 19 0
11 9 0
1 8 0
2 9 1
4 3 1
12 15 2
0 9 2
