width 20
height 20
.........@.@.......@
.........@......@..@
....@......@........
.@....@..@..........
...............@....
.....@......@....@..
.........@...@......
................@...
....................
.......@....@.@.....
..@......@......@...
......@.............
...........@.@......
.........@..........
........@.@......@..
..@.................
......@........@....
....@...............
.........@..........
....@@..............
15
5 15 0
16 18 0
9 12 0
5 14 0
4 18 0
5 2 1
14 18 1
19 9 1
5 18 1
0 14 1
7 4 2
7 13 2
2 11 2
10 2 2
11 10 2

0 19 0
18 19 0
8 5 0
2 3 0
7 16 0
3 7 1
16 13 1
19 11 1
15 12 1
3 12 1
0 11 2
10 12 2
17 0 2
11 13 2
10 11 2
