width 20
height 20
.............@@.....
....................
..........@...@...@.
................@...
..@...@.....@.......
..........@.....@...
...@.....@.@........
................@.@.
..........@.........
.......@.@........@.
..@.......@..@......
......@.@.......@...
..@.................
.@...........@....@.
............@.@.....
.........@......@...
....@...@......@....
....@...............
....@...............
....@...........@...
9
11 3 0
6 15 0
15 11 0
19 1 1
18 0 1
13 15 1
12 1 2
5 2 2
17 0 2

5 19 0
5 9 0
5 2 0
19 3 1
17 7 1
13 17 1
12 3 2
18 16 2
0 2 2
