width 20
height 20
@@@@@@@@@@@@.@.@.@@@
@@@@@@@@@@@@......@@
...@@@@@@@@..@.@@...
@@.@@@@@@@.@.@@.@.@.
@...@@@@.....@@..@..
@.@..@.@.@.@.@.@...@
...@.@.@@@.@...@@.@@
.@@..@....@.@@..@@@@
.@@@..@.@.@....@@@@@
..@.@....@@.@.@@@@@@
.@@...@.@@..@.@@@@@@
.@@.@..@@@@.@@@@@@@@
.@@..@.@@@@.@@.@.@@@
@@@.@.@.@...........
@@@.......@.@.@.@.@@
@@@@.@@@@@@@@@..@.@@
@@@@@@@@@@@@@@@.@@@@
@@@@@@@@@@@@@@@...@@
@@@@@@@@@@@@@@@@@.@@
@@@@@@@@@@@@@@@@@@@@
14
5 13 0
10 10 0
1 5 0
10 5 0
8 9 0
9 14 1
9 13 1
14 8 1
17 15 1
8 14 1
10 13 2
17 14 2
3 11 2
3 10 2

10 4 0
3 7 0
16 0 0
12 2 0
17 6 0
16 4 1
13 13 1
2 6 1
8 14 1
6 9 1
7 9 2
17 3 2
8 4 2
18 5 2
