width 20
height 20
@@@@@@@@@@@@@@@@@@@@
@@@@@@@@@@@@@@@@@@@@
@@@@@@@@@@@@@@@@@@@@
@@@@@@@@@@@@@@@@@@@@
@@@@@@@@@@@@@@@@@@@@
@@@@@@@@@@@@@@@@@@@@
@@@@@@@@@@.@@@@@@@@@
@@.@@@@@@...@@@@@@@@
@...@@@@@@.@@@@@@@@@
@.@.@@@@@@..@@@@@@@@
@..@.@@.@.@.@@@@@@@@
@@........@..@@@.@@@
@@@.@.@.@.@.@@@...@@
@@@@..@@.......@.@@@
@@@@.@@@@@.@.@...@@@
@@@@@@@@.@.@@@.@.@@@
@@@@@@@....@@...@@@@
@@@@@@@@.@@@@@.@@@@@
@@@@@@...@@@@@.@@@@@
@@@@@@@.@@@@@@....@@
14
14 14 0
9 13 0
3 9 0
3 11 0
15 19 0
11 12 1
10 16 1
16 19 1
10 9 1
2 10 1
11 13 2
11 10 2
3 12 2
8 11 2

3 8 0
9 13 0
10 14 0
11 12 0
1 8 0
10 16 1
2 8 1
10 15 1
1 9 1
15 19 1
11 13 2
6 11 2
12 13 2
12 14 2
