width 20
height 20
@@.@.@@@@@@.@.@.@@@@
@@.@..@@@@.......@@@
.....@@@@@.@@@@.@@@@
@.@.@..@@..@@@@..@@@
.@@.@.@.@@.@@@..@@@@
.@..........@.@.@.@.
...@@.@@@.@@@.......
@.@..@@@.@....@.@@.@
@...@@@..@@.@..@@@..
..@..@..@.@.@.@@@@@.
.@..@@@.@..@..@@@@@@
..@.@.....@.@..@@@@@
@.@...@@@.@...@.@@@@
@.@.@.@@@@..@@..@@@@
@@@..@@.@.@...@.@@@@
@@..@.....@.@....@@@
@@@..@@.@..@@.@.@@@@
@@..@@@@@@.@.@@....@
@@.@@@@@@.......@.@.
@..@@@@@@@.@.@.@....
14
14 19 0
15 16 0
13 5 0
9 3 0
3 4 0
9 11 1
9 12 1
11 7 1
9 15 1
19 19 1
8 8 2
0 5 2
13 10 2
14 4 2

13 9 0
9 3 0
1 2 0
15 1 0
5 13 0
9 15 1
2 5 1
0 5 1
16 6 1
7 9 1
3 11 2
19 5 2
6 5 2
2 17 2
