width 20
height 20
@...................
.........@..........
....................
....@.........@.@...
...@................
.@.........@...@....
....................
.........@..........
.@....@..........@..
...........@........
...............@....
....@.@.@....@......
...@................
.............@..@...
.........@..........
....................
..@............@....
.....@.@....@.@.....
..........@.........
@.......@...........
3
17 7 0
6 3 1
4 8 2

17 7 0
17 19 1
7 10 2
