width 20
height 20
@@..................
@@.................@
@@.@.@.@.........@..
@........@..........
..........@.@.......
..............@.....
........@.@.........
...@.@..............
..@......@..........
...........@...@....
......@.....@.......
...@.@.@.@........@@
..................@@
....@.......@..@..@@
....................
............@.......
.......@..@@........
.....@..............
.@....@.@......@....
....@@@@@...........
3
5 10 0
0 4 1
6 5 2

15 0 0
0 5 1
15 3 2
