width 20
height 20
..................@@
................@..@
.......@...........@
........@......@...@
.........@...@.@...@
....@...@.........@.
..........@.........
.....@.........@....
....@..@......@..@..
........@...........
....@...............
.....@........@.....
.............@...@..
.........@..........
@...................
.......@..........@.
.........@....@.....
....@...@...........
...@.....@........@.
...................@
3
14 2 0
18 6 1
11 18 2

2 9 0
13 15 1
0 5 2
