width 20
height 20
........@....@......
.....@..............
....................
........@...@.......
......@......@...@..
.........@..........
....................
.....@.@.@..........
........@......@....
....@......@........
.......@............
....................
...@............@...
....@............@..
@..........@.@......
...............@....
.........@..........
............@.@.....
...@.....@..........
....................
3
2 8 0
3 6 1
18 8 2

19 12 0
19 0 1
18 8 2
