width 20
height 20
@..@@.@@@@@.@.@@@@.@
@.@.@...@@....@@@...
......@@.@@.@@@@.@.@
@.@.@.........@.....
@..@@.@@.@@.@@@.@.@.
@@@.@.@@@....@...@..
@.@....@..@.@@@.@.@@
@...@.@@@@.@@@.....@
..@@.@.@.@..@.@.@@@.
@.@........@........
@...@.@.@@..@.@.@.@.
..@..@@@.@.@.@@@@@@.
@..@..@.......@@@...
@.@..@.@.@.@.@@@.@.@
@@..@.....@.........
@.@.@@@@.@..@.@.@@.@
......@@@@@..@@@...@
@@@.@..@@@.@@.@@.@..
@@@@..@.@.........@.
@@@@@....@@@@.@@.@@@
10
3 14 0
11 16 0
19 5 0
8 3 0
11 14 1
10 10 1
14 5 1
9 9 2
3 7 2
3 15 2

4 13 0
6 3 0
18 2 0
15 5 0
15 14 1
7 9 1
1 11 1
12 5 2
2 7 2
6 19 2
