width 20
height 20
@.........@@......@@
@@.@.@.@.@.@.@.@.@@@
@@@@.@@......@@@@@..
@@..@@@@.@.@@.@.@.@.
@@@..@..@...........
..@.@..@.@.@.@.@.@.@
@.....@.....@.@.@...
@@@.@...@.@...@..@.@
@@@@..@.@.@@.@.@....
@@@@.@.@.@@@.@.@.@@.
.@@.......@@@..@.@.@
...@.@.@.@@@.@...@..
.@.@@...@@@..@.@.@.@
..@...@.@@.@.@@.....
@.@@.@........@@.@.@
..@.@.@.@@.@@@.@@..@
@.@.@....@.@.@..@@.@
......@.@......@@@@@
@@@.@.@@.@.@@.@@@@@@
@@..@.....@...@@@@@@
10
1 17 0
16 8 0
8 0 0
18 7 0
2 17 1
16 0 1
4 13 1
8 2 2
8 14 2
9 14 2

1 16 0
10 6 0
5 12 0
8 11 0
2 19 1
10 2 1
6 0 1
12 16 2
2 1 2
18 6 2
