width 20
height 20
....@@@@@@@...@.@...
@.@.@@@@@@@@.@....@.
..@..@@@@.@..@@.@@.@
@@..@.@@@.@.@.@.....
@.@............@.@.@
..@@.@@.@.@.@@....@@
@.@.@.@.@@...@.@.@@@
........@@.@.@..@@@@
.@.@.@.@.@@.@.@.@@@@
..@@.@@........@@@@@
.@.@....@.@.@.@@@@@@
...@@.@.@@..@..@@@@@
.@...@.@.@.@..@.@@@@
@..@......@@@.....@@
..@..@@.@..@..@.@@..
.@.@..@@..@.@.@@..@.
...@@...@.@......@..
.@..@.@..@.@.@.@.@@.
@..@@@..@@....@.....
@@....@...@@.@@@.@.@
10
14 9 0
2 18 0
3 7 0
0 8 0
18 16 1
0 0 1
13 16 1
14 11 2
17 15 2
7 19 2

13 13 0
11 5 0
9 14 0
18 2 0
16 18 1
19 18 1
13 16 1
13 14 2
19 1 2
10 9 2
