width 20
height 20
@@@@@@@@@@@@.@.@@@@@
@@@@@@@.@@@@...@@@.@
@@@@@....@@.@.@@@...
@@@@.@@@.@@.....@@.@
@@@.........@.@.....
@@@@@.@.@.@.@@..@@.@
@@@@@@...@@@@..@...@
@@@@@.@@@@....@@@@..
@@@@....@..@.@@@@@@.
.@...@.@.@.@..@@@@@@
.@.@@.@@...@.@@@@@@@
.........@.@@@@@@@@@
.@.@.@.@.@@.@@@@@@@@
@...@...@....@.@@@@@
@@.@@.@@@@.@@..@@@@@
@@.@@.........@@@@@@
@@@@@.@.@.@.@..@@@@@
@@@@@@@@@@@@@.@@@@@@
@@@@@@@@@@@@..@@@@@@
@@@@@@@@@@@@.@@@@@@@
9
0 10 0
19 4 0
11 12 0
2 13 1
18 7 1
16 4 1
5 16 2
2 9 2
14 13 2

19 8 0
6 4 0
13 18 0
7 6 1
12 18 1
5 14 1
11 3 2
9 4 2
19 4 2
