width 20
height 20
@@@@@@@@@@@@@@@@@@.@
@@@@@@@@@.@@@@@@@@.@
@@@@@@@@..@.@@@.@...
@@@@@@@@.@...@@...@.
@@@@@@@....@....@@@@
@@@@@@@@.@.@.@@.@@@@
@@@@@@@..@@...@@.@@@
@@@@@@@@.@.@.@.@.@@@
@@@@@@.@.@..........
.@@@@..@@..@.@.@@.@@
..@@@@..@@.@@@@.....
.@@@.@.@....@@@@@.@.
.@@..@.@@@.@.@@@...@
...@.........@.@@.@@
@.@.@.@.@@@@...@@@@@
@.....@@.....@.@@@@@
..@.@@@.@.@.@@@@@@@@
.@@@@.....@@@@@@@@@@
.@@@@.@@@...@@@@@@@@
..@@@@@...@@@@@@@@@@
9
16 10 0
16 6 0
8 3 0
11 15 1
2 13 1
8 7 1
10 7 2
15 5 2
5 14 2

16 10 0
12 5 0
10 5 0
14 4 1
2 15 1
0 18 1
12 8 2
15 5 2
16 3 2
