width 20
height 20
@......@....@.......
@.@.................
...............@....
................@...
........@.....@.....
...@........@.....@.
...........@.@......
....................
.............@......
..@...@...@.........
......@.............
....................
......@..@.....@.@..
.@........@.........
......@......@......
..@.@...@...@..@....
....................
@......@..........@.
@@@.................
@@@@..@.............
8
6 16 0
3 14 0
9 4 0
3 0 0
1 16 0
18 11 0
9 16 0
13 18 0

19 0 0
1 3 0
11 0 0
8 2 0
8 11 0
8 5 0
1 5 0
15 19 0
