width 20
height 20
@@..................
@@.......@...@..@...
@.......@...@.......
...................@
...........@........
........@...........
.....@..............
.....@..............
.....@......@.......
.@......@....@......
....................
.................@..
...@.@.@............
.........@@.........
.@.@...............@
..............@.....
....................
...........@.....@..
...@...@............
....................
8
4 10 0
8 3 0
14 0 0
12 3 0
7 1 0
12 7 0
5 13 0
4 0 0

18 0 0
10 1 0
9 7 0
3 16 0
7 1 0
12 15 0
5 15 0
0 9 0
