width 20
height 20
@@@@@@@@@@@@@@@@@.@@
@@@@@@@@@@@@@@@@...@
@@@@@@@@@@@@@@@..@..
@@@@@@@@@@@@@@@@.@.@
@@@@@@@@@@@@@.@@@...
@@@@@@@@@@@@....@@.@
@@@@@@.@.@@.@.@@....
@@@@@..........@.@@.
.@@@@@.@@@@.@.@@@@@.
.@.@.@@....@....@@..
.....@..@@..@@.@@.@.
@.@.@.@.@.@@.@......
@@.............@.@@@
@@@.@.@.@.@@.@..@...
@@@@@.@@@.@...@...@.
@@@@@....@@.@@@@.@..
@@@@.@@.@....@@@@@@@
@@@.....@@.@..@@@@@@
@@@@.@.@.@.@@.@@@@@@
@@@@.@....@@@@@@@@@@
2
14 7 0
11 6 0

7 7 0
12 5 0
