width 20
height 20
@@@@@@@@@@@@@@@@@@@@
@@@@@@@@@@@@@@@@@@@@
@@@@@@@@@@@@@@@@@@@@
@@@@@@@@@@@@@...@@@@
@@@@@@@@@@@@@.@@.@@@
@@@@@@@@@@@.@.@...@@
@@@@@@@@@@@.....@@@@
@@@@@@@@@@@.@.@.@@@@
@@@@@@@@@@@..@@@@@@@
@@@@.@..@@@.@@@@@@@@
@@@@..@.@@...@.@.@@@
@@@@@......@@.......
@@@@..@.@.@@.@.@.@@.
@@@@@..@..@....@@@..
@@@@@@.@@@.@@@....@.
@@.@........@@@.@@@.
@....@.@.@.@.@.@@@..
..@.@@@@@.......@.@.
@.@..@@@@@.@@@@.....
@@..@@@@@....@@.@.@.
2
11 7 0
19 15 0

14 17 0
11 6 0
