width 20
height 20
...............@....
.@..........@.@.....
..@.......@.........
...........@@.......
.....@.@............
......@.....@.......
....................
.......@............
................@...
.....@..............
.......@.@..........
..@...@.....@...@..@
....................
.........@......@...
....................
.@....@.@.....@.....
@@...........@......
.......@......@..@@@
.................@@@
............@....@@@
4
2 17 0
18 9 0
3 12 1
13 17 2

16 9 0
19 9 0
14 18 1
8 18 2
