width 20
height 20
@@.@................
........@.......@..@
....................
....................
...@...@...@........
....@........@..@...
....................
@......@............
@@@..........@.....@
.@..@....@.........@
................@...
....................
....@...............
.............@......
.@..@............@..
.........@.@........
................@...
.@.@.....@.......@..
.....@..........@...
....................
4
0 14 0
5 15 0
7 0 1
4 18 2

5 5 0
8 6 0
8 0 1
9 6 2
