width 20
height 20
@@@@@@@@.@@.......@.
@@@@@@@.....@.@.@@..
@@@@@@..@.@.@@..@@@.
@@..@@@..@@@.@.@@@@.
@..@.@.@..@...@@@@..
@@.......@.@.@.....@
@@@.@.@@.@.....@@.@@
@@@..@@@..@.@.@@@.@.
@@..@@@@.@@@...@.@..
@@@@@@@@..@..@.....@
@@@@@@@@.@.@.@@.@.@.
@@@@@@@@......@..@..
@@@@@@@@@.@.@@..@..@
@@@@@@@@@@....@...@@
@@@@@@@@@.@.@@..@@@@
@@@@@@@@....@@@.@.@@
@@@@@@@@@.@.@@@....@
@@@@@@@...@@@@..@@..
@@@@@@@@@...@@@@...@
@@@@@@@@..@@@@@@@.@@
13
15 15 0
10 5 0
18 1 0
15 1 0
12 6 0
14 0 0
11 14 0
4 4 0
15 5 0
7 1 0
12 5 0
8 0 0
12 10 0

6 4 0
14 0 0
5 5 0
9 11 0
9 2 0
12 4 0
17 12 0
17 15 0
9 15 0
11 9 0
14 8 0
16 13 0
4 7 0
