width 20
height 20
..@..@@@@@.@..@....@
@...@@@@.@.@.@.@.@..
@.@........@......@.
@@..@@.@.@@@.@@@.@.@
@.@..@@@..@.@.......
....@@@@@.....@@@.@.
@.@..@@@@@.@.@@@@@..
...@.@..@...@@@.@..@
@.@.@.@.@@.@@@@.@@..
@...@....@..@@...@.@
@@@.@@@.@@.@@@@.@@@@
@@@.@@@..@@@@@...@@@
@@......@..@@@@.@.@@
@@@.@.@...@@..@...@@
@@@..@..@.@@@...@.@@
@.@@@@@@...@@@.@..@@
.........@..@@@..@@@
@@@.@.@@@@@..@.@.@@@
....@...@@@@........
@.@..@.@@@@@@.@.@@.@
13
12 5 0
3 5 0
17 14 0
1 0 0
8 4 0
11 16 0
9 5 0
8 13 0
7 9 0
1 18 0
6 2 0
4 0 0
1 9 0

0 5 0
15 9 0
10 16 0
12 18 0
11 17 0
14 2 0
1 19 0
15 14 0
8 16 0
16 0 0
1 18 0
15 4 0
6 3 0
