width 20
height 20
@@@@@@@@@@@@@@@..@..
@..@@@@@@@@@@@..@.@.
..@..@@@@@@@@@@.....
@...@@@@@@@.@@@.@.@.
..@.@@@@@....@@@..@@
@.@.@@@.@@.@.@@.@.@@
@@...@...@@.......@@
@@@.@@@.@.@@.@.@@@@@
@@...@@......@.@.@@@
@..@@@@@.@@.@@....@@
@@.@.@@....@...@@.@@
@......@@.@..@@.....
..@@@.@@@@..@@@.@.@.
@...@@.@@@@@@@@@.@..
.@.@@..@@@..@@@@..@.
....@@..@@@.@.@..@..
.@@@.@.@@@.....@..@.
...........@@.@.@.@.
@.@@.@.@.@.@........
....@...@..@@.@.@@.@
14
11 3 0
14 10 0
19 11 0
11 9 0
0 14 0
4 2 0
12 4 0
17 3 0
15 12 0
16 13 0
15 0 0
9 17 0
3 13 0
16 2 0

7 8 0
1 12 0
15 0 0
12 4 0
11 16 0
19 2 0
5 17 0
1 5 0
14 8 0
17 17 0
16 18 0
17 11 0
15 12 0
4 6 0
