width 20
height 20
@@@@@@@@@@@.......@@
@@@@@@@@@@.@.@.@.@@@
@@@@@@@@@..@@@.@.@@@
@@@@@@@@@@...@..@@@@
@@@@@@@@@@.@.@.@@@.@
@@@@@@@@@@@.........
@@@@@@@@@@@@.@@@.@.@
@@@@@@@@@@@@@....@.@
@@@@@@@@@@@@@@.@.@@@
@@@@@@@@@@@@....@@@@
@@@@@@@@@@@..@.@.@.@
@@@@@@@@@@.@.@......
@@@@@@@@@.....@.@.@.
@@@@@@@@@@.@.@@..@..
@@@@@@@@@@@@@@@@.@@.
@@@@@@@@@@@@@@@@@@@@
@@@@@@@@@@@@@@@@@@@@
@@@@@@@@@@@@@@@@@@@@
@@@@@@@@@@@@@@@@@@@@
@@@@@@@@@@@@@@@@@@@@
14
11 0 0
14 0 0
17 11 0
15 0 0
14 4 0
19 5 0
16 11 0
16 1 0
16 5 0
10 4 0
10 12 0
11 10 0
12 0 0
13 5 0

12 6 0
15 5 0
10 11 0
16 6 0
12 10 0
19 14 0
19 12 0
11 3 0
14 3 0
17 5 0
16 7 0
12 3 0
14 10 0
10 2 0
