width 20
height 20
@@@@@@@@@@@@@@@@@@@@
@@@@@@@@@@@@@@@@@@@@
@@@@@@@@@@@@@@@@@@@@
@@@@@@@@@@@@@@@@@@@@
@@@@@@@@@@@@@@@@@@@@
@@@@@@@@@@@@@@@@@@@@
@@@@@@@@@@@@@@@@@@@@
@@@@@@@@@@@@@@@@@@@@
@@@@@@@@@@@@@@@@@@@@
@@@@@@@@@@@@@@@@@@@@
@@@@@@@.@@@@@@@.@@@@
@@@@@@...@@@@@...@@@
@@@@@@@.@..@@.@.@..@
@@@@@@....@@....@@..
@@@@@@@.@....@@....@
@@@@@@@@..@@...@@.@@
@@@@@@@..@@@@@..@...
@@@@@@..@..@@@.@..@.
@@@@@@@.@@.....@@@..
@@@@@@@..@@.@@...@.@
14
9 15 0
14 19 0
16 17 0
7 17 0
9 13 0
13 15 0
11 14 0
13 13 0
19 13 0
7 13 0
18 14 0
11 18 0
7 16 0
7 18 0

19 16 0
17 12 0
17 14 0
15 13 0
14 16 0
9 17 0
18 18 0
13 12 0
7 19 0
16 17 0
18 13 0
11 14 0
15 11 0
18 19 0
