width 20
height 20
@@@@@@@@@@@@@@@@@@@@
@@@@@@@@@@@@@@@@@@@@
@@@@@@@@@@@@@@@@@@@@
@@@@@@@@@@@@@@@@@@@@
@@@@@@@@@@@@@@@@@@@@
@@@@@@@@@@@@@@@@@@@@
@@@@@@@@@@@@@@@@@@@@
@@@@@@@@@@@@.@@@@@@@
@@@@@@@@@@.@..@@@@@@
@@@@@@@@.....@@@@@@@
@@@@@.@.@@.@@.@.@@@@
@@@@@...........@@@@
@@@@..@.@@@.@.@@.@@@
@@@@@@..@@@..@@...@@
@@@@@@@..@..@..@@.@.
@@@@@@.@@..@.@......
@@@@@..@.@.....@.@.@
@@@@@@.....@@.@@@...
@@@@@@@.@.@.@@.@@@@@
@@@@@@@@@.......@@@@
10
8 9 0
13 17 0
13 10 0
7 12 0
11 18 0
15 15 0
12 7 0
18 17 0
7 10 0
11 16 0

13 11 0
18 15 0
11 14 0
14 19 0
16 12 0
10 19 0
9 9 0
9 17 0
5 11 0
7 18 0
