width 40
height 40
@@@.......................@..........@@.
@@...................@..................
.......@...@......@................@....
.........@............@...........@.....
...@.......@............@...@.@.........
....@...@.......@.....................@.
..................@.@....@..............
.@...@................@................@
...........@.@...............@.@..@.....
........@.......@......................@
.............@.................@..@..@.@
...........@............@...@...........
..@..@......@..@..@............@........
....@.@.........@.......................
...........@.....@..........@.......@...
..@........................@...@........
....@...................@...............
..............................@.........
....@.....@...........@@.@......@.......
......@......@..@.....@@....@......@....
..@......@.........@..................@.
...........@...............@.......@....
....@.........@....@....@...............
.........@...@..@...@........@..@..@....
....@.......@....@...............@....@.
.........@.@......@..@...@..............
...@..........@...........@.@....@....@.
...............................@......@.
......@.........@.......@...............
....................@.....@.........@...
.@...................@.....@.....@......
...........@..@.........@.@............@
....@..@........@....................@..
@......@............................@...
@.................@......@..@......@....
...@.....@...........@..........@.....@@
......@.........@.@...@...@.@.........@@
.........@...@.......................@@@
.............................@@.......@@
.............................@@@....@@@@
9
13 25 0
17 5 0
25 0 0
27 8 1
38 9 1
6 32 1
25 11 2
39 20 2
8 22 2

35 26 0
39 12 0
18 22 0
33 25 1
38 7 1
39 34 1
27 39 2
38 9 2
36 35 2
