width 20
height 20
@@@@@@@@@@@@@.@@@...
@@@@@@@@@@@@@..@.@.@
@@@...@@.@@@.@......
@@.@.@@...@....@.@.@
@....@.@.@.@.@@@@...
.@.@...........@..@.
....@@@.@.@.@@@..@..
@@.@.@.@..@.@.@@..@.
...@....@..@@.@@.@@.
.@...@.@@.@...@@@@@.
.@.@.@..@..@@..@@@@@
..@@@..@.@@.@.@..@..
.@.@.@..........@.@.
......@.@.@.@.@.....
.@.@.@...@@..@.@@.@.
.@@...@.@..@.....@..
.@@@.@.@@@...@.@@.@@
..@.....@@@.@.......
@@@@.@@@@@@@..@.@.@.
@@@@@@@@@@@@@@..@@..
1
0 5 0

15 12 0
