width 20
height 20
@@@@@...............
@@..................
..@.......@.......@.
....................
...@......@.........
.@....@.............
.........@..........
...@...@............
...............@....
..@.................
...@.........@@.....
....................
...........@....@...
.......@............
...........@........
@.......@.@...@.....
.....@.......@...@..
....................
..........@.........
....................
12
0 17 0
7 4 0
9 7 0
14 12 0
4 18 0
13 9 0
16 14 0
6 13 0
19 6 0
12 17 0
6 2 0
19 9 0

14 2 0
11 4 0
19 2 0
5 2 0
15 2 0
0 18 0
8 17 0
18 6 0
0 19 0
10 6 0
16 13 0
9 16 0
