width 20
height 20
..........@......@@@
..........@.....@...
..........@@........
@.............@.@..@
..@..@..............
......@.....@.@.@...
....................
@...@..........@....
.....@............@.
....@...@..@........
...@......@..@......
....................
..@.................
...@.@......@.......
@.....@.@..@...@....
...@...........@....
.....@.........@@...
...........@..@@@..@
..............@@@@.@
@.......@@....@@@@@@
12
17 10 0
9 5 0
4 3 0
8 3 0
0 10 0
8 13 0
8 2 0
12 9 0
19 1 0
6 12 0
18 6 0
3 3 0

0 2 0
0 5 0
10 7 0
18 13 0
19 1 0
10 19 0
4 2 0
12 10 0
10 8 0
4 14 0
14 12 0
17 2 0
