width 20
height 20
@..@................
..@.........@.@.....
......@.............
.....@..............
.................@.@
..@......@.........@
..............@....@
........@....@......
..@.............@...
....@..@...@.@......
..................@.
....@@..@.....@.....
....................
....@.......@.@.....
..........@.........
...............@.@..
@@............@.....
@..@..@@.@..........
.......@.....@@@.@@@
......@@.....@@@@@@@
16
3 1 0
16 10 0
2 2 0
18 4 0
8 0 0
11 6 0
10 3 0
1 7 0
0 5 0
15 2 0
10 15 0
4 18 0
9 10 0
3 18 0
8 13 0
13 16 0

15 10 0
7 8 0
14 7 0
3 15 0
15 2 0
2 9 0
6 16 0
19 3 0
5 18 0
0 18 0
11 19 0
18 5 0
12 8 0
19 2 0
9 10 0
12 16 0
