width 20
height 20
@@@@@@@@@@@@@@..@.@@
@@@@.@@@@.@@@.@...@@
@@@...@....@....@@@@
...@.@.@@.@..@@.....
@@.....@...@..@.@.@.
...@.@..@.@..@...@..
@.@@@.@....@.@@.@@@@
...@....@@@..@.@.@.@
.@.@@@@.@@@@........
@..@@@@..@@..@@@.@.@
.@..@@@@.@.@@..@@...
...@.@.@@...@.@..@.@
@.@.......@....@....
....@@.@@.@.@@...@.@
.@@.@@..@..@.@.@..@@
...@.@.@@.@...@..@@.
.@....@...@.@@.@....
@..@.@.@@@.......@@.
..@.@@.@@@@.@.@.@@@.
@.......@@@..@...@@@
7
17 4 0
1 17 0
15 3 0
14 17 0
1 19 0
13 1 0
2 3 0

15 0 0
10 14 0
3 19 0
15 18 0
14 7 0
7 2 0
12 9 0
