width 20
height 20
@@@@..@.@..@......@.
@@@@@.....@.@.@.@...
@@@...@.@.....@@..@@
@..@@@...@.@@@@@@...
..@.@.@.@.@....@@.@.
@..........@@.@.@@..
@@@.@.@.@.@........@
@@@@.@@@@@..@.@.@@.@
@@@..@.@@@@.@@.@@.@.
@@.@.@...@..........
.....@.@..@.@.@@.@@.
@@.@@..@@@@@.@@...@@
.@....@.@@.@.@.@@...
...@@......@......@@
.@.@@@.@.@@..@.@@.@@
..@@@.@@@@@@..@@@@@@
.@.@...@.@...@.@@.@.
.....@.....@........
.@.@..@.@.@@@.@.@.@.
..@@@@...@....@..@..
7
14 0 0
8 9 0
12 4 0
8 5 0
15 6 0
19 9 0
11 4 0

14 0 0
5 11 0
16 17 0
2 17 0
5 15 0
1 15 0
12 4 0
