width 20
height 20
.@@....@.@...@@@@@@@
..@.@.@....@.@@@@@@@
.@@..@@@.@..@@@@@@@@
..@.@.@@.@.@.@@@@@@@
@........@....@@@@@@
..@.@.@@..@.@..@@@@@
@..@@.@@.@.@..@@@@@@
@@@@.@@.@@.@@.@@@@@@
@@@..@...@....@@@@@@
@..@.@.@...@.@@@@@@@
.@.....@.@.@.@@@@@@@
...@.@..@@@.@.@@@@@@
.@.@@..@.@....@@@@@@
..@..@....@@@...@@@@
@...@@@@@..@.@.@@@@@
@.@..@.@.@......@@@@
.@..@....@.@.@.@@@@@
...@@@@@..@.@....@@@
.@.@@@@@@.@...@.@@@@
@...@@@@....@.@..@@@
7
0 17 0
8 16 0
3 10 0
4 7 0
5 16 0
0 18 0
8 19 0

13 8 0
11 11 0
4 8 0
8 13 0
8 9 0
1 14 0
7 1 0
