width 20
height 20
....................
....................
....@....@..........
.....@......@.......
.......@.........@.@
@.........@...@....@
@@.......@...@...@..
@.............@.....
.....@..............
...........@....@.@.
....................
....@.....@.........
...........@........
.......@........@...
..@............@....
.....@..........@...
........@....@......
......@.............
....................
....................
1
13 13 0

12 10 0
