width 20
height 20
@@@@@@@@@@@@.....@@@
@@@@@@@@.@@..@@.@.@@
@@@@@@@..@@.@@....@@
@@@@@@@@....@.@.@...
@@@@@@@@@.@@....@.@.
@@@@@@@@@@@.@.@@@@..
@@@@@@@@@@......@@@@
@@@@@@@@@@@.@.@.@..@
@@@@@@@@@@@@@@...@.@
@@@@@@@@@@..@.@@.@.@
@@@@@@@@@@@.........
@@@@@@@@@@@@.@.@@.@.
@@@@@@@@@@@..@@@@@@@
@@@@@@@@@@@@....@@@@
@@@@@@@@@@@@@@@@@@@@
@@@@@@@@@@@@@@@@@@@@
@@@@@@@@@@@@@@@@@@@@
@@@@@@@@@@@@@@@@@@@@
@@@@@@@@@@@@@@@@@@@@
@@@@@@@@@@@@@@@@@@@@
5
16 10 0
18 9 0
11 6 0
8 2 0
13 4 0

11 2 0
18 10 0
11 9 0
17 3 0
14 13 0
