width 40
height 40
......@....@.....................@......
..@...@............@...................@
........@......@..@.............@@.....@
.................@.......@.............@
............@...........@....@..@.......
.@.....@..@..@.@...@....................
.........@.......@......................
..@........................@....@.......
.....@.......@....@......@....@.........
..........@..........@..............@...
.......................@...@...@.@...@.@
.........@..@.....@....................@
....................@@@..@.@........@..@
................................@.......
...........@......@.....................
..............@...................@.@...
....@...............@......@............
........@.......@......@................
@@.....@....@.......@....@...........@..
@@.........................@..........@.
@@..@..@......@....@..@......@..@.......
.........@.....@.@......................
.@....@...@.............@.....@.....@.@.
...........@.................@..........
.@........@......@.........@..@......@..
.......@....@.@.@.................@.@...
...............@.................@......
...@........@......@....@...............
.....@..........@..........@.....@......
...............@......@.................
..................@..@...............@..
....@....@..........@....@....@..@......
........@.@...@..@......................
............................@...........
...@.@..@.....@..................@......
.........@.....@.............@..........
....@............@.@@...@.........@.....
.....@.............@@...............@...
........@..........@@...@......@........
.........................@..........@@..
13
33 23 0
34 9 0
3 24 0
5 35 0
34 16 0
13 2 1
12 1 1
25 34 1
32 19 1
21 20 2
31 16 2
3 23 2
24 7 2

15 11 0
21 14 0
4 26 0
4 39 0
3 22 0
7 10 1
2 9 1
3 37 1
12 9 1
13 29 2
4 38 2
34 39 2
36 4 2
