width 20
height 20
................@...
....................
.............@....@.
.......@.@...@......
...@................
..@.....@...........
............@.......
....@@..........@.@.
...@........@.......
..@..............@..
.........@..........
.....@..............
............@.......
...................@
...@.....@.........@
.@.....@............
.....@..........@...
....................
...@.@.@....@..@....
@...................
10
18 16 0
7 8 0
9 17 0
12 0 0
0 9 1
1 7 1
1 0 1
9 1 2
12 17 2
15 6 2

8 17 0
0 17 0
1 4 0
4 15 0
4 12 1
19 19 1
14 5 1
4 4 2
13 8 2
3 15 2
