width 20
height 20
....................
............@.......
....@...............
........@..@........
....@........@.....@
....................
..@...@....@........
...............@....
............@.....@.
...@.....@......@...
.....@....@..@......
............@.......
....@...............
.....@.....@..@.@..@
..........@...@.....
..............@.....
.......@...........@
@@@.................
@@@@................
@@@@@@..............
10
11 2 0
0 16 0
6 17 0
0 3 0
9 1 1
18 10 1
2 4 1
17 8 2
7 2 2
15 2 2

13 13 0
3 16 0
1 2 0
4 8 0
17 13 1
13 17 1
19 17 1
6 3 2
4 3 2
16 4 2
