width 20
height 20
.......@..@@.....@@.
..........@.........
..@@.@.............@
........@...........
.......@.....@......
............@.@.....
......@....@........
...@..........@.....
.........@..........
..@.....@...........
...........@........
....@.....@.@@......
..@..@......@@......
.............@......
....@.@..@........@.
..............@.....
................@...
@...................
........@...........
@...................
10
1 19 0
18 8 0
3 16 0
5 7 0
17 12 1
12 3 1
5 10 1
1 1 2
2 0 2
3 14 2

12 1 0
3 14 0
6 15 0
1 10 0
14 13 1
11 15 1
1 0 1
3 0 2
11 7 2
18 5 2
