width 20
height 20
....................
.......@............
..@...@.@...........
....................
....................
...@....@...@.@@....
...................@
.@.....@........@...
............@.......
....................
........@.@.@.@.....
...@...@...@....@...
......@.............
.....@..............
..........@.........
......@.....@..@....
@...............@...
.....@.......@......
..@...@...........@.
@...................
10
0 18 0
14 14 0
9 4 0
13 14 0
16 5 1
0 13 1
17 19 1
16 0 2
4 11 2
11 14 2

15 14 0
6 3 0
19 18 0
13 3 0
3 19 1
0 13 1
17 19 1
19 4 2
10 6 2
5 1 2
