width 20
height 20
@..@................
......@........@....
.....@..............
..@......@.@........
....................
..@......@..........
...@......@...@@...@
.@..................
...........@........
..@..@..@....@..@...
.......@............
....................
........@...........
...........@..@.....
........@......@..@@
......@.............
.....@......@.@.....
@........@..........
..@................@
...............@@@@@
8
5 1 0
11 9 0
1 19 0
0 5 1
18 3 1
5 17 1
5 19 2
15 2 2

18 16 0
2 16 0
15 3 0
17 5 1
1 18 1
19 5 1
0 12 2
18 1 2
