width 20
height 20
@..@@.@.@@@@.....@.@
@@..@...@@@@@.@@.@.@
@..@@.@@@@@@.@@.....
@@......@@@@...@.@@.
@@@.@.@.@@.@.@....@.
@@@@@..@@...@..@@..@
@@@@@@...@.@.@.@@.@.
@@@@..@.@.......@@@.
@@@.@...@@.@.@@.@@..
@@@...@.@...@@@....@
@.@.@.@@@@.@.@@@.@..
@.@@@...@@@@.@@@@..@
...@@.@..@....@@.@..
@.@@.@@.@.@.@......@
.............@.@@@@@
@@@.@.@.@@.@..@@@@@@
.@@@...@@@@@.@.@.@.@
.....@@....@........
.@.@...@.@...@.@.@.@
..@@@.@@@@@.@@@...@@
8
19 4 0
17 4 0
13 0 0
12 8 1
12 3 1
6 1 1
5 16 2
2 18 2

7 17 0
15 8 0
12 7 0
18 1 1
0 19 1
6 1 1
12 3 2
1 12 2
