width 20
height 20
@@@@@@@@@@@@@@@@@@@@
@@@@@@@@@@@@@@@@@@@@
@@@@@@@@@@@@@@@@@@@@
@@@@@@@@@@@@@@@@@@@@
@@@@@@@@@@@@@@@@@@@@
@@@@@@@@@@@@@@@@@@@@
@@@@@@@@@@@@@@@@@@@@
@@@@@@@@@@@@@@@@@@..
@@@@@@@@@@@@@@@@@.@.
@@@@@@@@@@@@@@@@@.@.
.@@@@@@@@@@@@@@@@.@.
.@@@.@@@@@@@@@@@....
.@....@.@@@@@@@@@@@.
...@@....@@@@@@..@@.
.@.@@@.@@.@@@@.@....
..@@@......@@@...@@.
@@.@.@.@@.@.@..@...@
@....@@.@.@...@.@.@@
@@@.@.@.@.@.@@...@@@
@..............@.@@@
8
19 15 0
2 17 0
16 18 0
19 12 1
7 19 1
16 14 1
3 12 2
1 17 2

9 19 0
13 19 0
15 13 0
6 19 1
14 16 1
2 17 1
19 14 2
0 12 2
