width 20
height 20
@@@@@@@@...@@@@@@@@.
@@@@@@@@@@..@@@@@@..
@@@@@@@..@.@@@@@@.@.
@@@@@@@.@...........
@@@@@@@..@@.@.@@@.@.
@@@@@@..@@@@.@.@...@
@@@@@.@..@.@.@.@@@.@
@@@@....@..........@
@@@@@.@@@@.@.@@.@@.@
@@@@@.@@@@..@@@@@@@@
.@@@..@....@.@..@..@
...@.@.@@@.@.@@.@@..
.@.................@
@.@.@@.@.@.@.@.@.@..
......@@@@.@..@...@@
@.@.@@....@@.@@@@.@@
@@@..@.@@...@@@@@@@@
@@@@....@.@@@@@@@@@@
@@@@.@.@@@@@@@@@@@@@
@@@@@..@@@@@@@@@@@@@
8
19 0 0
10 16 0
6 19 0
15 7 1
7 10 1
17 7 1
1 14 2
10 6 2

6 15 0
12 12 0
13 3 0
11 16 1
7 15 1
14 6 1
3 13 2
14 3 2
