width 20
height 20
@..@.@..@..@@@@@....
.@....@..@..@@@.@.@.
...@.@..@@@..@.....@
@.@.@@@..@..@.@.@@..
.....@..@@@...@.@..@
@.@.@.@..@@@@..@..@.
.@@.....@.@.@.@.@...
..@.@@@...........@.
@..@.@.@@@.@.@.@@@..
.@.......@.@.@.@...@
...@.@.@.@@.@.@.@.@@
.@..@..@............
@@.@.@@.@.@.@.@.@.@.
.........@@@@@...@..
.@.@.@@@..@.@.@.@@@.
.@@@@@.@.@..@....@..
...@......@...@.@@@.
.@..@.@@.@..@.@.@@@@
@.@..@.@..@@..@@@@@@
....@@...@@@@...@@@@
10
11 15 0
1 7 0
4 4 0
2 17 0
11 7 0
16 7 0
14 7 0
6 2 0
10 3 0
18 3 0

6 9 0
16 15 0
2 19 0
17 2 0
3 17 0
6 11 0
14 19 0
13 7 0
7 13 0
10 0 0
