width 20
height 20
@@@.@..@@....@@@@...
.....@..@@@@..@@.@.@
.@.@...@@@@..@@@....
..@..@.@@@.@..@..@.@
@.@@..@@@@.@.@.@..@@
@@.@.@.@@........@.@
@........@.@.@.@....
@.@.@@@.@..@..@@@@.@
.@@@.@..@@.@.@@@@...
..@@..@..@@@.@@@..@.
@....@..@.@.@.@.@.@.
.@.@.@@............@
..@@...@.@.@@.@.@@..
.@...@.@@.@..@....@.
...@@.@.@...@@@.@@..
.@........@..@@.@@@.
..@.@.@.@.@.@@@.@@@.
.@.@.@@@@@..@@@@@@..
......@.@..@.@@.@@@.
@.@@@....@..........
10
11 0 0
2 11 0
4 5 0
15 18 0
4 2 0
3 16 0
14 4 0
2 17 0
1 3 0
15 12 0

7 11 0
15 19 0
15 12 0
3 1 0
7 14 0
10 18 0
4 2 0
0 16 0
4 18 0
7 10 0
