width 20
height 20
@@@@@@@@@@@@@@@@@@@@
@@@@@@@@@@@@@@@@@@@@
@@@@@@@@@@@@@@@@@@@@
@@@@@@@@@@@@@@..@@@@
@@@@@@@@@@@.@..@@@@@
@@@@@@@@@.@..@..@@@@
@@@@@@@@....@@.@.@@@
@.@@@@@@@@@.......@@
...@@@@@@@..@@.@@..@
.@..@.@@@.@...@...@@
@..@...@....@@@@@@@@
.@...@.@.@.@@@@@@@@@
.@.@.@....@@@@@@@@@@
....@@@.@@@@@@@@@@@@
@@.@..@@@@@@@@@@@@@@
@....@@@@@@@@@@@@@@@
@@.@@@@@@@@@@@@@@@@@
@@@@@@@@@@@@@@@@@@@@
@@@@@@@@@@@@@@@@@@@@
@@@@@@@@@@@@@@@@@@@@
2
2 10 0
3 9 1

16 9 0
1 10 1
