width 20
height 20
@@@@@@@@@@.@@.@@@@@@
@@@@@@@@@...@.@@@@@@
@@@@@@@@@.@....@@@@@
@@@@@@@@...@@.@@@@@.
@@@@@@@@.@@...@@@@..
@@@@@@..@@@@.@@@@.@.
@@@@@@.@@@@...@@....
@@@@@....@.@@.@.@@.@
@@@@.@.@@..@........
@.@......@...@.@.@.@
..@.@@.@...@@@@.@...
@...@@@@.@..@@....@.
..@@@@@@@@@..@@.@@..
@.@@@@@@@@@@@@@...@.
@@@@@@@@@@@@@@..@.@.
@@@@@@@@@@@@@@@@..@.
@@@@@@@@@@@@@@@..@.@
@@@@@@@@@@@@@@@@.@.@
@@@@@@@@@@@@@.......
@@@@@@@@@@@@@.@@.@.@
3
16 11 0
18 7 1
16 9 2

16 11 0
5 9 1
17 15 2
