width 20
height 20
....................
.............@.....@
....................
....@.@..........@..
.@..................
........@...@.......
@................@..
...@...@@....@......
.........@.....@....
..........@..@...@..
............@.......
.@...@..............
@...@.@...@.........
@........@..@...@...
@.@..............@..
...............@..@.
..@..@........@....@
.........@......@...
.....@.....@........
....................
7
3 15 0
15 19 0
2 13 0
7 18 1
14 11 1
15 12 2
10 1 2

17 8 0
4 2 0
18 11 0
9 1 1
1 2 1
12 0 2
11 1 2
