width 20
height 20
.@.@@@@@@@@@@.@.@.@.
...@@@@@.@..........
@.@@@@@...@@@.@@@.@@
...@@@@@.@.@.@.@..@.
.@@@@@..........@...
..@@@@@@.@.@.@@...@.
.@@.@@.@.@@.@@@@.@..
..@..@.......@@@@@@@
@...@.@@@@.@..@@.@@@
..@@...@@@@.@..@....
@....@@.@@....@@.@.@
@@@@.....@@.@....@@.
@@@@.@@.@.@.@.@@....
@@@..@......@@@.@.@@
@@@@..@.@@.@@@..@...
@.@..@@.@..@@.@...@@
..@@...@@@....@.@...
@.@.@@..@@.@.@...@.@
@......@@.@..@@.@.@.
@.@@.@.....@..@.....
5
1 3 0
19 19 0
1 18 1
16 8 1
19 9 2

16 3 0
19 14 0
4 10 1
18 17 1
19 9 2
