width 20
height 20
@@@@@@@@@@@@@......@
@@@@@@@@@@@@@@.@.@..
@@@.@@@@@...@..@@..@
..@.@@@@@.@@@@.@@@..
@....@@@..@.@@@@.@.@
..@@@.@@.@.....@....
.@@.@......@@.@..@.@
......@.@.@.....@..@
@@@.@..@.@@@.@@..@..
.....@...@@@@...@..@
@.@@@..@...@@@@@.@.@
@@@@@@..@@@@@@@@....
@@@@@@@@@@@@@@@@@@.@
@@@@@@@@@@@@@@@@@@@@
@@@@@@@@@@@@@@@@@@@@
@@@@@@@@@@@@@@@@@@@@
@@@@@@@@@@@@@@@@@@@@
@@@@@@@@@@@@@@@@@@@@
@@@@@@@@@@@@@@@@@@@@
@@@@@@@@@@@@@@@@@@@@
5
1 10 0
2 7 0
8 10 1
6 11 1
3 8 2

2 7 0
11 2 0
5 8 1
18 3 1
13 9 2
