width 20
height 20
@@@@@@@..@@@@@@@@@@@
@@@@@@..@@@@@@@@@@@@
@@@@...@@@@@@@@@@@@@
@.@.@.@..@@@@@@@@@@@
......@.@@@@@@@@@@@@
.@@.@.....@@@@@@@@@@
@..@..@.@.@@@@@@@@@@
@.@@@.@@@@@@@@@@@@@@
...@...@@@@@@@.@@@@@
@.@.@.@@@.@@....@@@@
.............@.@.@@@
@@.@.@.@@.@@@..@...@
...@@.@@@@.@..@@@.@@
@.@@..@@...@@.@@@..@
@@@@@...@.@.@..@..@@
@@@@@.@.@.....@@.@@@
@...@@....@.@.@@.@@@
@@.@..@.@..@......@@
.....@..@.@@@.@.@@@@
@@.@...@..@@@@...@@@
5
3 10 0
10 10 0
5 19 1
6 2 1
14 19 2

15 9 0
0 18 0
7 6 1
7 10 1
9 5 2
