width 20
height 20
@@@@@@.@.@@...@...@@
@@@@@..@....@..@.@@@
@@@@.@...@@@.@...@@@
@.@@.@.@..@....@...@
..@..@@..@@@.@@@.@@@
@.@.@.@@..@..@..@@@.
@.....@..@.@...@.@..
..@@@.@.@...@@.@..@.
.@......@.@@@@...@..
..@@.@@....@...@...@
@...@@..@.@@@@@..@@@
@@@.@..@@..@...@..@@
@@@@@@@@@.@..@...@@@
@@@@@@@@@..@.@@@.@@@
@@@@@@@@..@@@....@@@
@@@@@@@@@..@.@.@.@@@
.@@.@@@@@.@.....@@@@
......@@.@.@.@@@@@@@
@@.@@..@......@.@@@@
@....@...@.@@....@@@
5
3 16 0
8 19 0
1 3 1
2 18 1
8 4 2

8 19 0
2 18 0
4 9 1
13 18 1
9 13 2
