width 20
height 20
@@@@@@@@@@@@@@@@@@@@
@@@@@@@@@@@@@@@@@@@@
@@@@@@@@@@@@@@@@@@@@
@@@@@@@@@@@@@@@@@@@@
@@@@@@@@@@@@@@@@@@@@
@@@@@@@@@@@@@@@@@@@@
@@@@@@@@@@@@@@@@@@@@
@@.@@.@@@@@@.@@@@@@@
@@.@...@@@...@@@@@@@
.....@.@@@.@@@@@@@.@
@@.@.@........@@@...
@@@.@..@@@.@.@@@.@.@
@.@...@@@@@.........
....@.@@@@@@.@.@.@.@
@.@..@@@@@@@@.@.@@..
@@..@@@@.@@@@.@.@@@.
@@@@@@@@...@........
@@@@@@@@@@...@@@@@@.
@@@@@@@@@@@@....@...
@@@@@@@@@@@..@@@..@.
5
3 9 0
14 12 0
19 15 1
4 8 1
16 11 2

15 16 0
17 16 0
6 10 1
2 10 1
18 16 2
