width 20
height 20
..........@@@@@..@..
.....@......@@......
....@...............
.........@.......@..
..@.....@...........
.................@..
.....@.........@....
.......@............
.....@.@..@.........
.@.........@..@..@..
.........@.........@
....@.......@...@.@.
....................
...@.........@......
....................
.....@........@.....
.@.....@...@........
.........@.........@
...@@...............
...@@...............
10
0 0 0
2 2 0
10 14 0
7 9 0
10 11 1
11 5 1
4 15 1
4 13 2
10 10 2
12 10 2

9 18 0
12 18 0
18 5 0
8 6 0
10 12 1
0 0 1
19 2 1
6 10 2
11 10 2
12 7 2
