width 20
height 20
@..................@
.......@...........@
......@...@@.@.@@..@
..........@@...@@...
...@................
.@..................
........@..@........
....................
....@.............@.
@.............@.....
@.@.................
@...................
@@@.....@........@..
@@.........@........
@...................
.........@.....@....
............@...@...
.......@......@.....
...........@.....@..
........@@.@@.....@@
10
1 15 0
5 11 0
9 14 0
3 19 0
17 15 1
16 18 1
9 16 1
13 17 2
12 6 2
17 1 2

8 13 0
12 3 0
0 6 0
13 14 0
5 2 1
3 3 1
5 15 1
6 5 2
5 18 2
14 8 2
