width 20
height 20
...@.........@@@....
....................
..@......@..........
....................
.............@....@.
.........@....@..@..
..@.......@.........
.......@............
.........@...@....@.
.....@......@....@..
....@...........@...
..........@.@.......
...............@.@@.
.........@........@@
..........@...@.....
...@............@...
........@...........
..@........@..@.....
...........@.@......
...........@........
10
16 16 0
16 8 0
13 12 0
11 3 0
18 2 1
10 5 1
14 18 1
7 9 2
15 5 2
12 8 2

14 16 0
10 2 0
1 3 0
4 18 0
5 6 1
10 3 1
2 4 1
14 12 2
3 18 2
17 11 2
