width 20
height 20
@....@........@@@...
....................
............@.......
.............@.@...@
....@..@...........@
....................
..@.................
.@...@.@.@..@....@..
......@@......@...@.
...@................
............@..@..@.
.........@.......@..
.@..................
@@...@...@..........
....................
..........@@........
...............@....
.......@........@...
.......@............
.............@@@....
10
3 3 0
4 19 0
18 17 0
10 1 0
15 1 1
4 15 1
15 12 1
0 16 2
10 13 2
14 16 2

3 3 0
4 12 0
6 3 0
0 16 0
8 19 1
13 1 1
5 3 1
4 0 2
10 13 2
0 7 2
