width 20
height 20
....@@@@......@@...@
.@@..@@.@.@.@..@.@.@
@.@.@.....@@..@@@...
......@.@...@..@..@@
.@@.@.@@..@.@@@.@.@.
@.@.@..@@..@.@......
.....@..@.@....@.@@.
@@.@@.@@...@.@.@.@@@
.@@.@.@.@.@@.@@.@.@.
..@...@.@.@.........
.@..@......@.@@.@.@.
..@..@.@.@@@@@@.@@..
@...@...@..@@@.@.@@.
..@.@@@@.@..@..@....
@..@@.@@...@@.@..@@.
..@......@.....@.@@@
@...@@.@.@@@.@...@@.
..@.@@@.@..@@@@@.@..
.@.@.@....@...@.@.@.
.......@@...@.......
2
16 3 0
3 12 1

1 6 0
5 19 1
