width 20
height 20
@@@@@@@@@@@@@@@@@@@@
@@@@@@@@@@@@@@@@@@@@
@@@@@@@@@@@@@@@@@@@@
@@@@@@@@@@@@@@@@..@.
@@@@@@@@@@@@@@@@@...
@@@@@@@@@@@@@@@@@.@@
@@@@@@@@@@@@@@@@....
@@@@@@@@@@@@@@@@@.@.
.@@@@@@@@@@@@@@@...@
.@@@@...@@@@@@@@@.@@
.@....@@.@.@..@...@@
.@@@.@.@.....@@.@@@@
.........@@@.@......
.@.@.@.@.@....@.@@@.
.@@.@...@..@@.@@@@..
....@@.@@.@.@.@.@@.@
.@.@@@@@@@..........
..@@@@@...@@.@@@.@@.
.@@@@@@.@@.....@.@@.
..@@.......@@.@@..@@
1
2 15 0

13 10 0
