width 20
height 20
@@@@@@@..@@@@.@.@.@@
@@@@@@.@..@.........
@@@@@....@@.@@.@.@@.
@.@@.@.@@@@..@@@@@@@
.........@@.@...@@@@
@@.@.@@.@.@...@@.@@@
....@.@....@@.....@@
@@.@@...@.@...@@@.@@
@@@@..@@@.@@.@....@@
@@@@@@....@.@@.@.@.@
@@@@@.@.@....@.@@..@
@@@@@...@.@@...@..@@
@@@@..@.@@@@@@@..@@@
@@@@@.@@.@@@.@..@@@@
@@@@......@...@..@@@
@@@.@@.@.@..@...@@@@
@......@@.@..@.@.@@@
@.@@.@......@....@@@
@...@..@@.@@@@.@@@@@
@.@@@@..@@@@@@@@@@@@
1
3 6 0

6 3 0
