width 20
height 20
@@@@@@@@..@.@.@.@@@.
@@@@@@@@@.@.@.@..@..
@@@@@@@@..@.@...@.@.
@@..@@@@@.....@.@...
@@.@@@@@..@@@@.@@.@.
@@..@.@.@.@.@..@...@
@@@.........@.@.@.@@
@@@.@.@.@.@.........
@@@@..@@.@..@.@.@@.@
@@@@@.@..@.@...@....
@@@@@@.@.@..@.@@@.@.
@@@@@@.....@@@@@@@@@
@@@@@@.@@@.@@@@@@@@@
@@@@.@....@@@@@@@@@@
@@@@...@.@@@@@@@@@@@
@@@@@@..@@@@@@@@@@@@
@@@@@@@..@@@@@@@@@@@
@@@@@@@@@@@@@@@@@@@@
@@@@@@@@@@@@@@@@@@@@
@@@@@@@@@@@@@@@@@@@@
9
19 2 0
11 8 0
8 2 0
9 0 1
15 6 1
6 14 1
14 4 2
13 3 2
7 7 2

15 0 0
13 6 0
6 11 0
9 2 1
6 15 1
4 13 1
15 2 2
18 1 2
18 8 2
