width 20
height 20
@.......@.....@...@@
..@.@.@@.@@@.@@.@@@@
.@.@.@@..@@..@.....@
........@..@..@.@.@@
.@@.@.@..@...@...@@@
...@@@@@...@@..@@@@@
@@....@..@@@..@..@@@
@@@.@@..@@@..@.@.@@.
@@@.@.@..@.@...@....
@@..@..@.@.@.@...@.@
@@.@..@..@...@.@.@@@
@@@@@.@@.@.@.@@..@@@
@@@@@.@.....@@..@..@
@@@@...@.@.@..@.@.@.
@@@@@.@.@....@.@....
@@@@@.....@@.@...@@.
@@@@.@.@.@@@...@..@.
@@@@...@.@@..@.@.@.@
@@@@@.@@@@@.@..@@...
@@@@@@@@@@@@@@....@@
9
10 0 0
8 15 0
18 2 0
2 10 1
0 1 1
14 4 1
16 10 2
12 17 2
0 5 2

13 3 0
15 19 0
18 14 0
3 1 1
7 14 1
1 5 1
1 1 2
4 16 2
17 14 2
