width 20
height 20
@.@......@@@@@@@@@@@
...@.@.@.@@@@@@@@@@@
@@.@.@@...@@@@@@@@@@
@....@.@.@@@@@@@@@@@
..@@.@.....@@@@@@@@@
@@..@..@@@@.@@@@@@@@
@.@...@@..@.@..@@@@@
@...@@@@@...@@..@@@@
..@@@@@@@.@@...@@@@@
.@.@@@.@..@@.@...@.@
.....@...@@@@..@@...
.@@.@..@.@@@@@...@.@
@.....@.@@@@@@.@....
@@.@@...@.@@@..@.@.@
@@@.@@.@@..@@.@...@@
@@......@@...@.@.@.@
@@@@@@.@..@@........
.......@.@...@@@.@.@
@.@@.@...@@.@@@..@..
...@.@@@....@@@.@..@
9
11 15 0
4 17 0
10 17 0
19 16 1
6 13 1
1 18 1
17 16 2
3 15 2
4 18 2

14 10 0
1 0 0
11 5 0
6 4 1
14 9 1
11 18 1
6 0 2
2 3 2
4 2 2
