width 20
height 20
@@@@@@.@..@..@@@@@@@
@@@@@@.@@.@.@@@@@@@@
@.@@@.......@@@@@@@@
...@..@@.@.@@@@@@@@@
.@...@....@@@@@@@@@@
@..@..@.@.@@@@@@@@@@
@.@.@.@..@@@@@@@@@@@
....@@@@@.@@@@@@@@@@
@@@.@.@....@@@@@@@@@
.@......@.@@@@@@@@@@
...@@.@.@..@@@@@@@@@
.@.@@@.@@.@@@@@@@@@@
@...@.....@@@@@@@@@@
@@.@..@.@.@@@@@@@@@@
@@@@.@.@.@.@@@@@@@@@
@@..........@@@@@@@@
@@@@.@.@@.@.@@@@@@@@
@@@@@@@....@@@@@@@@@
@@@@@...@.@@@@@@@@@@
@@@@@@.@@.@@@@@@@@@@
9
7 2 0
0 11 0
0 9 0
8 2 1
9 0 1
1 6 1
11 2 2
7 6 2
9 17 2

2 4 0
0 11 0
3 12 0
4 15 1
1 6 1
2 5 1
6 1 2
10 14 2
8 6 2
