width 20
height 20
.@@..@..@@...@@...@@
...@..@..@@.@.@.@.@@
@.@.@...@........@.@
....@.@@..@.@.@.@...
.@@.@.@.@.@@.@....@.
@.........@..@@.@@..
@.@.@.@.@...@@@.@@@.
@..@@@@@@.@....@@@..
@@..@.@@.@.@.@@@@@@.
@..@@.......@.@@@@..
.@..@.@.@@.@@..@..@.
.@.@.@@@@...@.@.@...
...@.@@@.@@.......@.
.@....@.....@@.@.@@.
..@.@@..@@.@@@@@@...
@..@@@@...@@@@@@@@.@
@.@@@@@@.@@@@@@@@@.@
..@@@@@@..@@@@@@@@@@
@..@@@@..@.@@@@@@@@@
..@@@@@@....@@@@@@@@
9
11 1 0
11 12 0
18 5 0
6 2 1
19 14 1
16 0 1
18 3 2
8 12 2
9 2 2

7 14 0
4 12 0
19 3 0
19 4 1
9 7 1
0 4 1
1 19 2
11 11 2
12 4 2
