width 20
height 20
...@.@......@..@@@@.
@@.....@@.@..@..@@@.
@@@@@.@.@@.@..@.@...
@@@@@@.......@@...@.
@@@@@@@.@@.@@@..@..@
@@@@@@@.@.@@...@@@@.
@@@@@@@......@.@....
@@@@@@@@.@.@.@@..@@.
@@@@@@@..@@.@.@@.@..
@@@@@@.@.@@...@.@.@.
@@@@@....@@.@.......
@@@@@@@@....@.@.@.@.
@@@@@@@@.@.@@@@@@@..
@@@@@@@@@@@.@.@.@@@.
@@@@@@@@.@....@.@...
@@@@@@@@.@@.@@....@@
@@@@@@@........@@...
@@@@@@@@.@.@.@@@@.@.
@@@@@@@@@@..@.@@.@@.
@@@@@@@@@@@@........
9
11 8 0
9 16 0
8 7 0
2 1 1
14 4 1
16 10 1
15 10 2
8 14 2
17 17 2

13 5 0
7 5 0
15 10 0
8 17 1
13 11 1
13 0 1
8 11 2
17 14 2
7 2 2
