width 20
height 20
@@@@@@.@.@...@...@@@
@@@@@......@.@@.@.@.
@@@@@@@.@.@..@......
@@@@@.@..@..@@.@@@@@
@@.@...@..@.........
...@@@...@..@.@.@.@.
.@..@.@@..@@.@...@@@
.@@......@.@.@@.@.@@
..@.@.@.@....@......
@.@@.@@@..@@.@.@.@.@
.....@@@@.@..@..@...
@@.@.@@@..@@.@@@.@.@
..@@@@@..@.....@.@..
@.@@...@@@@.@.@....@
.....@@.@....@@@.@..
@@.@....@@@.@@..@..@
@@@@@.@.@...@..@.@..
@@@@@@...@.@.@.@...@
@@@@@@.@.........@..
@@@@@@@..@.@.@.@..@.
9
2 11 0
6 13 0
14 12 0
8 18 1
1 12 1
10 7 1
4 10 2
5 4 2
9 6 2

7 3 0
7 7 0
14 9 0
12 18 1
4 15 1
3 6 1
5 8 2
0 12 2
19 19 2
