width 20
height 20
@.@@@@@@@@@@@@@@@@@@
...@.@@@@@@@@@@@@@@@
@.@@..@@@@@@@@@@@@@@
@.@..@@@@@@@@@@@@@@@
@.@@..@@@@@@@@@@@@@@
@....@@@@@@@@@@@@@@@
..@.@@@@@@@@@@@@@@@@
@..@@@@@@@@@@@@@@@@@
..@@@@@@@@@@@@@@@@@@
.@.@@@@@@@@@@@@@@@@@
........@@@@@@@@@@@@
.@@.@.@..@@@@@@@@@@@
...@@@@.@@@@@@@@@@@@
.@@.@...@@@@@@@@@@@@
@@@...@@@@@@@@@@@@@@
@@..@@@@@@@@@@@@@@@@
@.@.@@@@@@@@@@@@@@@@
.....@@@@@@@@@@@@@@@
@@.@..@@@@@@@@@@@@@@
@@@@.@@@@@@@@@@@@@@@
3
5 11 0
1 12 1
0 13 2

5 2 0
4 14 1
0 6 2
