width 20
height 20
@@.@...@@@@@@@@@@@@@
.....@.@@@@@@@@@@@@@
@.@.@@@@@@@@@@@@@@@@
@.@@...@@@@@@@@@@@@@
..@.@.@@@@@@@@@@@@@@
@.....@@@@@@@@@@@@@@
..@.@..@@@@@@@@@@@@@
@@.@..@@@@@@@@@@@@@@
@...@..@@@@@@@@@@@@@
.@.@.@..@@@@@@@@@@@@
.@.@...@.@@@@@@@@@@@
.....@...@@@@@@@@@@@
@.@@.@@.@@@@@@@@@@@@
...@@....@@@@@@@@@@@
.@.@@.@.@@@@@@@@@@@@
.@.@...@@@@@@@@@@@@@
@...@.@@@@@@@@@@@@@@
.@.@..@.@@@@@@@@@@@@
...@@....@@@@@@@@@@@
@.@...@@@@@@@@@@@@@@
3
2 16 0
2 1 1
4 10 2

2 14 0
6 9 1
2 5 2
