width 20
height 20
....................
.........@..@.@.....
....................
...@................
........@.@.........
.....@..............
...............@....
..@......@.@.....@..
....................
.........@@....@....
...@.....@@.....@...
......@.@@@........@
.........@@......@.@
..@......@..@..@...@
...@.....@.........@
......@.............
........@.......@...
.....@.@............
.@............@.....
.........@..........
15
6 3 0
0 6 0
7 10 0
1 4 0
13 11 0
16 11 1
10 2 1
4 9 1
11 12 1
19 18 1
4 17 2
15 0 2
16 3 2
16 18 2
12 14 2

7 1 0
11 13 0
17 1 0
1 6 0
13 10 0
2 12 1
11 2 1
0 12 1
1 1 1
13 2 1
6 16 2
2 19 2
0 13 2
2 0 2
3 5 2
