width 20
height 20
@@@@............@@..
@@@.................
.........@..........
....................
...............@....
....................
..............@.....
.........@..........
......@.@.@.........
.....@..............
...........@..@.....
.@.......@..@.....@.
.......@.........@.@
.@....@.............
....@.......@..@..@.
....................
....@...@....@......
....@.@.......@...@.
..................@.
........@@@@.......@
15
9 14 0
18 4 0
18 6 0
0 4 0
18 15 0
19 2 1
8 6 1
4 3 1
11 17 1
19 3 1
10 17 2
3 10 2
19 8 2
15 8 2
2 10 2

19 2 0
4 19 0
9 13 0
19 17 0
17 15 0
4 11 1
7 4 1
19 18 1
3 13 1
5 15 1
4 10 2
5 18 2
15 3 2
19 15 2
7 18 2
