width 20
height 20
....................
....................
....@...@..@...@....
..............@.....
...@........@.......
...................@
....@.@.@.@...@.....
....................
....@......@@.......
....@..@............
...@................
..@.@..@..@.@.......
....................
..@.@........@......
....@......@........
......@.............
....................
......@.............
.........@..........
....@........@......
15
2 4 0
3 7 0
0 13 0
5 2 0
18 13 0
1 18 1
4 15 1
15 16 1
10 12 1
2 8 1
5 11 2
7 18 2
8 1 2
15 18 2
7 14 2

14 19 0
10 4 0
19 0 0
3 7 0
2 0 0
10 18 1
19 3 1
2 1 1
8 11 1
17 17 1
13 5 2
16 6 2
19 18 2
15 16 2
14 16 2
