width 65
height 81
@@@@@@@@@@@@@@@@@@@@@@@@@@@@@@@@@@@@@@@@@@@@@@@@@@@@@@@@@@@@@@@@@
@@@@@@@@@@@@@@@@@@@@@@@@@@@@@@@@@@@@@@@@@@@@@@@@@@@@@@@@@@@@@@@@@
@@@@@.@@@@@.@@@@@@@.........@@@@@@@@@@@@@@@@@@@@@@@@@@@@@@@@@@@@@
@@@@........@@@@@@..........@@@@@@@@@@@@@@@@@@@@@@@@....@@@@@@@@@
@@@@........@@@@@@@.........@@@@@@@@@@@@@@@@@@@@@@@@...@@@@@@@@@@
@@@.........@@@@@@@..........@@@@@@@@@@@@@@@@@@@@@..........@@@@@
@@@........@@@@@@@@..........@@@@@@@@@@@@@@@@@@@@@..........@@@@@
@@.........@@@@@@@@..........@@@@@@@@@@@@@@@@@@@@@..........@@@@@
@@.........@@@@@@@...........@@@@@@@...@@@@...@@@@............@@@
@@.........@@@@@@@@@.........@@@@@@@....@@@...@@@.............@@@
@@.........@@@@@@@@@..........@@@@............................@@@
@@@............@@@@@..........................................@@@
@@@............@@@@...........................................@@@
@@@............@@@@..........................................@@@@
@@.............@@@@...........@@@@@....@@@.....@@@....@@@@@@@@@@@
@@@@...........@@@@.........@@@@@@@@@@@@@@@@@@@@@@@@@@@@@@@@@@@@@
@@@@.@@@@.....@@@@@@........@@@@@@@@@@@@@@@@@@@@@@@@@@@@@@@@@@@@@
@@@@.@@@@....@@@@@@@........@@@@@@@@@@@@@@@@@@@@@@@@@@@@@@@@@@@@@
@@@@.@@@@....@@@@@...........@@@@@@@@@@@@@@@@@@@@@@@@@@@@@@@@@@@@
@@@@.@@@@....................@@@@@@@....@@@@@@@@@@@........@@@@@@
@@@@.........................@@@@@@@....@@@@@@@@@@@.....@@@@@@@@@
@@@@.........................@@@@@......@@@@@@@@@@@.....@@@@@@@@@
@@@..........@@@@@@..........@@@@@......@@@@@@@@@@@.....@@@@@@@@@
@@@..........@@@@@@..........@@@@@......@@@@@@@@@@@.....@@@@@@@@@
@@@.@@@@@@@@@@@@@@@..........@@@@@@....@@@@@@@@@@@@.....@@@@@@@@@
@@..@@@@@@@@@@@@@@@..........@@@@@@....@@@@@@@@@@@@.....@@@@@@@@@
@@..@@@@@@@@@@@@@@@...........@@@@.....@@@@@@@@@@@@.....@@@@@@@@@
@@..@@@@@@@@@@@@@@@.....................................@@@@@@@@@
@@..@@@@@@@@@@@@@@@.....................................@@@@@@@@@
@@..@@@@@@@@@@@@@@@...........................................@@@
@@@@@@@@@@@@@@@@@@@...........@@@@............................@@@
@@@@@@@@@@@@@@@@@@@...........@@@@@@@@@@@@@@@@@@@@@@@@@@@@@@@@@@@
@@@@@@@@@@@@@@@@@@@...........@@@@@@@@@@@@@@@@@@@@@@@@@@@@@@@@@@@
@@@@@@@@@@@@@@@@@@............@@@@@@@@@@@@@@@@@@@@@@@@@@@@@@@@@@@
@@@@@@@@@@@@@@@@@@............@@@@@@@@@@@@@@@@@@@@@@@@@@@@@@@@@@@
@@@@@@@@@@@@@@@@@@.................@@@@@@@@@@@@@@@@@@@@@@@@@@@@@@
@@@@@@@@@@@@@@@@@@.................@@@@@@@....@@@@@@@.@@@@@@@@@@@
@@@@@@@@@@@@@@@@@@.....................@@@.....@@@.............@@
@@@@@@@@@@@@@@@@@@@............................................@@
@@@@@@@@@@@@@@@@@@@...........................................@@@
@@@@@@@@@@@@@@@@@@@...........................................@@@
@@@@@@@@@@@@@@@@@@@...........................................@@@
@@@@@@@@@@@@@@@@@@@..........................................@@@@
@@@@@@@@@@@@@@@@@@@@..................@@@@@@@@@..............@@@@
@@@@@@@@@@@@@@@@@@@@..................@@@@@@@@@..............@@@@
@@@@@@@@@@@@@@@@@@@@..@@@@.....@@@..@@@@@@@@@@@...............@@@
@@@@@@@@@@@@@@@@@@@@@@@@@@@...@@@@@@@@@@@@@@@@@@@@@...@@@@@@@@@@@
@@@@@@@@@@@@@@@@@@@@@@@@@@@...@@@@@@@@@@@@@@@@@@@@@...@@@@@@@@@@@
@@@@@@@@@@@@@@@@@@@@@@@@@@@...@@@@@@@@@@@@@@@@@@@@@...@@@@@@@@@@@
@@@@@@@@@@@@@@@@@@@@@@@@@@@...@@@@@@@@@@@@@@@@@@@@@@..@@@@@@@@@@@
@@@@@@@@.@@@@@@@.@@@@@@@@@.....@@@@@@@@@.@@@@@@@@@@......@@@@@@@@
@@@@@@@@.@@@@@@@.@@@@@@@..........@@@@@@.@@@@@@@@@@......@@@@@@@@
@@@@@@@@..@@@@@@.@@@@@@@..........@@@@@@.@@@@@@@@@@.......@@@@@@@
@@@@..@@..@@@.@@...@@@........................@@@@@.........@@@@@
@@............................................@@@@@.........@@@@@
@@............................................@@@@@........@@@@@@
@@............................................@@@@@........@@@@@@
@@...........@@.@.............................@@@@.........@@@@@@
@@@..@@......@@@@....@@.......................@@@@...........@@@@
@@@..@@@@@..@@@@@....@@@@.........@@@@@@.@@@..@@@@..........@@@@@
@@@..@@@@@...@@@@....@@@@.........@@@@@@.@@@@.@@@@............@@@
@@@..@@@.......@@...@@@@..........@@@@@@.@@@@.@@@@.....@@@@@@.@@@
@@@.................@@@@@.....@@@@@@@@@@@@@@@@@@@@@@@@@@@@@@@@@@@
@@....................@@....@@@@@@@@@@@@@@@@@@@@@@@@@@@@@@@@@@@@@
@@@@@@@@@@@@@@..............@@@@@@@@@@@@@@@@@@@@@@@@@@@@@@@@@@@@@
@@@@@@@@@@@@@@..............@@@@@@@@@@@@@@@@@@@@@@@@@.......@@@@@
@@@@@@@@@@@@@@................@@@@...........................@@@@
@@@@@@@@@@@@@@...............................................@@@@
@@@@@@.....@@@...............................................@@@@
@@@@@@.....@@@.................................................@@
@@@@@.....@@@@................@@@@.............................@@
@@@@@.....@@@@........@@@....@@@@@.............................@@
@@@@@.....@@@@........@@@....@@@@@.............................@@
@@@@@.....@@@@........@@@@@@..@@@@.............................@@
@@@@@.....@@@@........@@@@@@..@@@@@@...........................@@
@@@@@.....@@@@........@@@@@@..@@@@@@.............................
@@@@@............@@@..@@@@@@.@@@@@@@.............................
@@@@@...........@@@@..@@@@@@@@@@@@@@...@@@@@@@@@@@@@@@@@@@.......
@@@@@...........@@@@....@@@@@@@@@@@@...@@@@@@@@@@@@@@@@@@@.....@@
@@@@@@@@@@@@@@@@@@@@@@@@@@@@@@@@@@@@@@@@@@@@@@@@@@@@@@@@@@@@@@@@@
@@@@@@@@@@@@@@@@@@@@@@@@@@@@@@@@@@@@@@@@@@@@@@@@@@@@@@@@@@@@@@@@@
29
24 67 0
26 3 0
35 14 0
16 62 0
25 3 0
26 32 0
21 40 0
39 54 0
32 36 0
40 59 0
5 3 1
29 48 1
22 27 1
24 36 1
47 69 1
45 66 1
9 58 1
11 58 1
7 77 1
49 39 1
7 20 2
57 58 2
20 11 2
26 11 2
4 53 2
6 23 2
45 42 2
22 2 2
62 73 2

52 54 0
40 58 0
46 38 0
55 52 0
30 43 0
58 75 0
21 34 0
53 43 0
33 37 0
25 72 0
37 74 1
31 42 1
53 52 1
61 12 1
10 10 1
27 39 1
23 69 1
20 63 1
24 21 1
49 39 1
35 29 2
54 43 2
60 40 2
46 71 2
16 70 2
4 23 2
36 42 2
28 12 2
53 50 2
