width 40
height 40
.................@......................
..........................@.....@....@..
........................................
........@@..........@...........@.....@.
..@..@..@@@@........@.....@........@.@..
.@....@.@@@@............................
........@..@...........................@
..@..@....@@....@...............@.......
..........@@......@...........@......@..
..@........@..@.@.........@.............
.@.@.................@.....@........@...
......@......@..@..@...@....@...@.......
............@...........................
.................@....@...@...@.@....@..
.@..........@..@....................@...
......@....@.@...@.....@...........@....
.....@....@.......................@.....
.............@....@.....................
.....@......@.@.@.......@..@.......@....
..@..................@..................
.................@...........@..........
...@@.....@..@..........................
........@............@.............@....
................@...........@.@.........
....@.@...@.@......@...@................
.........@....@@@...@............@......
.............@@@@........@......@.......
@..@..@.@....@@@...@....@.@.@....@.....@
..@........................@...........@
@.....@.@..............@.....@..........
...............................@.@......
..............@..@..............@.....@.
..........@@...........@............@...
...@......@........@......@.@...........
..............@........@.....@.....@....
........@........................@......
......@...............@.............@@..
.@..............@........@......@...@@@@
.....@..........@.....@....@.....@@@@@@@
@...@.....@@.......@@@......@....@@@@@@@
48
34 28 0
26 39 0
17 6 0
11 12 0
31 28 0
7 29 0
25 28 0
35 17 0
32 6 0
30 2 0
29 14 0
15 0 0
30 31 0
28 4 0
2 30 0
5 5 0
30 26 1
9 27 1
16 30 1
21 36 1
18 4 1
29 19 1
20 37 1
8 28 1
36 30 1
4 18 1
30 33 1
11 21 1
31 16 1
17 9 1
3 36 1
21 15 1
25 3 2
5 2 2
8 26 2
19 16 2
30 34 2
12 26 2
13 18 2
7 38 2
21 27 2
5 26 2
6 8 2
27 20 2
34 37 2
23 38 2
7 12 2
35 7 2

20 5 0
28 18 0
16 6 0
8 14 0
1 13 0
21 9 0
25 28 0
3 39 0
32 6 0
7 36 0
1 38 0
14 10 0
18 26 0
30 24 0
19 9 0
24 6 0
13 5 1
30 28 1
13 30 1
26 15 1
23 17 1
11 17 1
19 20 1
39 8 1
32 17 1
33 10 1
19 4 1
38 0 1
9 29 1
1 34 1
23 7 1
10 1 1
10 18 2
7 0 2
26 20 2
21 13 2
17 18 2
14 19 2
36 8 2
6 35 2
30 30 2
39 13 2
26 18 2
1 21 2
0 31 2
26 22 2
37 2 2
16 1 2
