width 20
height 20
......@.@@.........@
....................
...............@....
.....@......@.......
......@..@...@......
...............@.@..
......@.@...........
..........@....@....
.@..................
....@....@...@......
................@...
.............@.@.@..
....................
......@.............
...........@........
@....@@.............
@....@......@....@..
...@@@@@.@....@.....
...@@@..............
...@@@..............
6
13 18 0
6 9 0
1 2 1
10 0 1
1 18 2
18 13 2

12 5 0
9 12 0
6 1 1
12 0 1
18 7 2
4 6 2
