width 20
height 20
@@@@@@@.............
...@@@.@............
...@@............@..
..................@@
..................@@
.@.....@............
..@.......@..@......
....@...............
.......@@...........
.......@@.........@.
......@@..@.........
...............@....
..@.....@.....@.....
..@.......@.........
@.@........@........
@....@.........@....
..................@.
....@.@...@...@.....
...........@@@......
..@@@......@........
6
11 13 0
4 8 0
16 9 1
0 3 1
7 0 2
13 14 2

11 12 0
12 14 0
8 19 1
2 10 1
18 11 2
16 19 2
