width 20
height 20
@.@....@@......@...@
...........@........
........@...........
....@...............
........@...........
...@..............@@
............@.......
..@............@....
.....@@@...@........
...@.........@......
........@.......@...
.......@.......@.@..
..@.........@.......
..............@.@...
..........@.@.......
......@.............
.@..@..@...@@..@....
...........@........
....@......@......@.
..........@@@@......
2
12 17 0
14 5 0

10 4 0
9 2 0
