width 20
height 20
...........@@.......
....................
...@..@...@.@.......
......@............@
................@..@
..@......@..@.......
.............@..@...
....@...............
............@.......
.@.....@............
........@........@..
..............@.....
......@...@@.@......
...............@@...
..........@....@....
...@................
........@.....@.....
............@@...@..
.@..................
..............@.....
2
9 8 0
18 7 0

15 8 0
6 7 0
