width 20
height 20
.............@.....@
.@........@.@.......
.....@.....@.....@..
.....@..@...........
...@..........@..@..
.@.................@
..@......@..........
...@......@.........
........@..@........
....................
..@..@............@.
...@..@...@.....@...
...............@....
............@...@...
.@...@..............
................@...
........@...........
....................
....................
....................
15
1 17 0
13 12 0
3 8 0
16 14 0
9 0 0
12 12 0
3 17 0
0 8 0
15 2 0
10 8 0
12 19 0
17 19 0
1 9 0
17 11 0
1 11 0

11 0 0
13 12 0
17 1 0
10 16 0
7 2 0
13 14 0
15 1 0
19 19 0
14 2 0
8 2 0
4 2 0
4 17 0
1 7 0
1 18 0
6 19 0
