width 20
height 20
...............@@@@@
.....@...@..@..@@@@@
...........@...@@@@@
...............@@@..
....................
...........@..@.....
.@..................
...@..@..@.@..@.@...
............@.......
....................
..@.....@...........
.................@..
....@...............
.@..................
................@...
.........@..........
@...........@..@...@
@..@................
@...................
@...................
15
13 17 0
5 15 0
2 14 0
11 8 0
1 0 0
7 2 0
9 19 0
16 11 0
16 4 0
18 13 0
13 3 0
7 12 0
6 8 0
15 4 0
13 9 0

18 7 0
13 16 0
19 14 0
15 13 0
19 19 0
11 8 0
6 14 0
14 10 0
16 4 0
7 12 0
16 13 0
8 12 0
5 8 0
8 11 0
12 10 0
