width 20
height 20
...........@@...@..@
...........@@..@..@@
....@@.....@@.......
....@....@..........
..........@.@..@....
.......@............
..............@.....
....@.@....@........
................@...
..@....@..@..@......
..............@.....
...................@
.....@.@.@.@.......@
.............@......
............@.......
..@......@..@.......
@.........@.....@...
.....@..............
................@...
....................
15
19 10 0
17 14 0
3 14 0
1 9 0
2 13 0
14 0 0
16 15 0
0 6 0
8 18 0
3 11 0
6 14 0
15 6 0
10 14 0
0 1 0
16 11 0

1 13 0
18 2 0
18 15 0
7 11 0
19 3 0
19 4 0
6 2 0
5 5 0
11 11 0
0 13 0
13 1 0
2 0 0
10 14 0
1 14 0
19 19 0
