width 20
height 20
@.@@@@@@@@@@@@@@@@@@
@.@@@@@@@@@@@@@@@@@@
.....@@.@@@@@@@@@@@@
@.@@....@@@@@.@@@@@@
@@@..@.@@@@@@.@@@@@@
@@.@.@@@@@@@@..@@@@@
@@.@..@@@@@@..@@@@@@
@@.@.@@@@@@.@...@@@@
@..@..@@@@....@@@@@@
@@...@@@@@.@.@@@@@@@
@..@@@@@@...@@@@@@@@
@@..@@.@@.@@@@@@@@@@
@@.@.@.....@@@@@@@@@
......@@@.@@@@@@@@@@
@@@@.@......@@@@@@@@
@@@...@.@@.@@@@@@@@@
.@@@.@.@.@..@@@@@@@@
.@.........@.@@.@@@@
...@.@.@.@.......@@@
@.@@@..@..@@.@.@@@@@
15
3 17 0
3 15 0
14 19 0
2 13 0
8 12 0
13 3 1
11 14 1
13 8 1
6 16 1
5 6 1
2 17 2
12 19 2
4 15 2
4 17 2
9 17 2

6 16 0
2 5 0
4 12 0
9 12 0
1 0 0
15 18 1
10 14 1
1 2 1
15 7 1
4 17 1
4 9 2
7 2 2
4 15 2
4 7 2
2 11 2
