width 20
height 20
@@..@@@@.@@.@@....@@
@@@.........@..@.@.@
@@@@.@@@.@@..@..@..@
@@@@.@.@.@.@.@.@.@.@
@@@@....@@.@.......@
@@@..@.@@....@.@@@..
@@@@@@...@.@@@@.@.@.
@@@@@@@.@....@@.@...
@@@@@@@@@@.@@.....@.
@@@@@@@@@@@@@@.@.@..
@@@@@@@@@@@@@@..@@@.
@@@@@@@@@@@@@@@@@@..
@@@@@@@@@@@@@@@@@@@.
@@@@@@@@@@@@@@@@@@@.
@@@@@@@@@@@@@@@@@@@@
@@@@@@@@@@@@@@@@@@@@
@@@@@@@@@@@@@@@@@@@@
@@@@@@@@@@@@@@@@@@@@
@@@@@@@@@@@@@@@@@@@@
@@@@@@@@@@@@@@@@@@@@
15
7 4 0
8 3 0
19 10 0
15 6 0
18 11 0
12 3 1
14 2 1
4 1 1
8 1 1
15 7 1
6 4 2
6 5 2
3 5 2
5 1 2
15 2 2

18 1 0
14 10 0
6 1 0
19 5 0
19 11 0
7 7 1
5 1 1
16 8 1
8 3 1
6 6 1
11 1 2
19 7 2
12 4 2
15 10 2
18 7 2
