width 20
height 20
@@@@@@@@@@@@.@@@@@@@
@@@@@@@@@@.@..@@@@@@
@@@@@@@@@...@..@@@@@
@@@@@@@@.@.@..@.@@@@
@@@@@@@......@...@@@
@@@.@@.@@.@@..@.@@@@
@@.....@@@@.@...@@@@
@@@.@@..@.....@..@@@
@@@...@@.@.@@@@@@@@@
@@..@........@@@@@..
@@@@..@.@.@.@.@@@.@.
@@.@.@..@@..........
@.....@.@.@@.@.@.@@.
@@@.@..@......@@..@.
@@@@.@.@@.@.@@@.@@@@
@@@@....@.@...@.@.@.
@@@..@.@@@..@.......
@@@@.@.@@@.@@@.@@.@@
@@@@@@@@@@@.@@..@...
@@@@@@@@@@.....@@.@.
15
16 11 0
10 8 0
12 12 0
11 14 0
13 13 0
14 17 1
15 5 1
10 2 1
17 18 1
19 13 1
4 15 2
19 18 2
3 6 2
10 9 2
14 19 2

16 11 0
7 9 0
15 18 0
12 13 0
18 18 0
10 9 1
19 13 1
13 2 1
12 15 1
5 6 1
19 12 2
3 8 2
9 10 2
5 10 2
19 16 2
