width 20
height 20
...................@
@..@..............@@
@...........@......@
......@....@.......@
@...................
....@...........@...
...@....@...........
.............@......
....@...@..@........
.....@..............
..........@..@...@..
.....@..............
..@.................
......@.....@.......
....@.........@.@.@.
...............@....
...@...@............
............@......@
...................@
......@............@
9
3 0 0
1 4 0
5 3 0
4 1 1
5 18 1
7 19 1
4 2 2
16 3 2
2 19 2

8 2 0
16 2 0
2 1 0
1 1 1
19 9 1
7 19 1
14 7 2
7 17 2
19 4 2
