width 20
height 20
@@@@@@@@@@@@@@@@@@@@
@@@@@@@@@@@@@@@@@@@@
@@@@@@@@@@@@@@@@@@@@
@@@@@@@@@@@@@@.@.@@@
@@@@@@@@@@@@@@.....@
@@@@@@@@@@@@@..@.@..
@@@@@@@@@@@@.@..@@.@
@@@@@@@@@@@....@@.@@
@@@@@@@@@@..@@.@....
@@@@@@@@@.@@.....@.@
@@@@@@@@...@.@@@@...
@@@@@@@@@@...@.@@.@.
@@@@@@@@@@.@@......@
@@@@@@@@@@@@@@.@@@.@
@@@@@@@@@.@.@@..@.@@
@@@@@@@@@.@.@.@....@
@@@@@@@.......@.@.@@
@@@@@@@@@.@.@...@..@
@@@@@@@@@@...@.@..@.
@@@@@@@@@@@@@...@...
17
7 16 0
13 12 0
9 14 0
14 11 0
10 12 0
17 7 0
8 16 1
17 18 1
16 8 1
19 5 1
16 18 1
19 8 1
18 19 2
10 11 2
14 8 2
12 18 2
11 17 2

11 7 0
11 14 0
9 16 0
11 18 0
10 10 0
19 10 0
14 17 1
14 18 1
18 13 1
14 12 1
18 15 1
19 8 1
15 4 2
18 10 2
18 17 2
13 12 2
19 18 2
