width 20
height 20
.@@@@@@@..@@@@@@@@@.
...@@@@@.@@@@@@@@@..
@.@.@.@..@@@@@@.@.@.
........@@@@@@......
@.@.@@.@@@@.@.@.@.@@
@@..@@@@@@.......@@@
@@.@.@.@@..@.@@@@@@@
@@......@.@..@@@@@@@
@@@.@@.@..@.@@@@@@@@
@@@@@@..@.@@@@@@@@@@
@@@.@.@.@.@@@@@@@@@@
@.......@..@@@@@@@@@
@@.@@.@.@@.@@@@@@@@@
@@@@@@.......@@@@@@@
@@@@@@@@.@.@...@@@@@
@@@@@@@@..@..@@@@@@@
@@@@@@@..@@@@@@@@@@@
@@@@@@@@@@@@@@@@@@@@
@@@@@@@@@@@@@@@@@@@@
@@@@@@@@@@@@@@@@@@@@
17
8 14 0
15 4 0
19 2 0
14 3 0
18 3 0
2 1 0
12 7 1
15 3 1
2 6 1
2 12 1
2 7 1
6 3 1
14 14 2
11 7 2
9 10 2
9 9 2
1 2 2

8 15 0
7 10 0
8 13 0
9 6 0
11 5 0
9 8 0
1 2 1
12 5 1
19 1 1
5 11 1
6 9 1
5 2 1
12 6 2
14 3 2
9 10 2
1 4 2
6 13 2
