width 20
height 20
.....@@@@..@@@@@@@@@
@@.@@...@@.@@@@..@@@
......@.@@..@@.@..@@
@.@@.@.@@.@..@.@.@@@
@..@........@....@@@
@.@@@.@.@.@...@.@@@@
.....@..@..@@.@@@@@.
@.@.@@@@..@@.....@..
@@@@@@@@@.@@@.@.@.@.
@@@@@@@@@@.@@.@@....
@@@@@@@@@@......@.@@
@@@@@@@@@@@@.@@.....
@@@@@@@@@@.@.@@.@.@.
@@@@@@@@@@...@..@@..
@@@@@@@@..@@@.@.@@@.
@@@@@@@@@........@@.
@@@@@@@...@@.@@@.@@.
@@@@@@@.@..@@@....@.
@@@@@@@@@@@....@.@..
@@@@@@@@@@@@@.@@.@@.
17
8 4 0
13 19 0
11 3 0
19 7 0
16 15 0
19 18 0
7 17 1
9 17 1
1 2 1
14 18 1
11 10 1
4 3 1
19 9 2
9 8 2
0 2 2
10 12 2
14 3 2

19 19 0
13 4 0
1 7 0
5 2 0
7 16 0
15 11 0
16 4 1
1 2 1
4 6 1
15 8 1
11 18 1
15 7 1
14 3 2
9 6 2
10 1 2
1 6 2
9 5 2
