width 20
height 20
...@..@.@.@.@@.@...@
@.@.@.......@....@..
......@.@@@...@.@.@.
@.@.@..@@@@@.@....@@
@..@..@@.@@@@@@.@.@@
..@@@.@@..@@@@@@...@
@..@.....@@@@@@@@.@.
..@.@.@.@@@@@@@@....
.@.....@@.@@@@@@@.@.
@..@@.@.@.@@@@@@@@..
..@.@......@@@@@@.@.
.@...@@.@@@@@.......
.@.@...@@..@.@.@.@@.
....@.@.@.@..@@.@.@.
.@.@........@.@.@...
@@@.@.@.@.@@....@.@.
.@@.@.@@..@.@.@....@
........@@@....@.@@@
@.@.@.@..@@.@.@@@@@@
@@...@..@@@.@@@@@@@@
12
4 11 0
19 9 0
4 0 0
17 3 0
14 17 1
0 17 1
11 13 1
0 5 1
14 12 2
6 10 2
18 1 2
14 11 2

7 14 0
19 11 0
8 18 0
4 0 0
9 9 1
5 0 1
11 16 1
15 3 1
4 12 2
16 1 2
0 13 2
19 12 2
