width 20
height 20
..@@..@...@.@@@....@
@.@.@.@@@....@..@.@.
@...@.@.@.@@@..@@@..
..@........@.@.@@@@.
@..@@.@@.@.......@..
.@.@.@.@..@.@.@@@..@
........@@.@@@.@..@.
.@.@@.@........@@...
.@@@@@..@.@.@@.@@.@.
.@@@@@@..@@@...@@@..
@..@@..@@@@..@..@@@.
..@@.@.@.@.@@.@...@.
@...............@@..
@.@@.@@.@.@.@.@.@.@.
@...@.@@.@..@.@...@.
@.@......@@..@@.@...
@@..@.@@@@@@.@.@..@.
@@@@...@@@@@@..@@.@@
@@@@@.@@.@.@..@....@
@@@@@.......@...@@..
14
4 13 0
9 5 0
4 17 0
13 7 0
6 8 0
10 14 1
17 14 1
0 7 1
19 1 1
1 0 1
6 12 2
11 12 2
1 1 2
14 8 2

4 15 0
15 4 0
1 10 0
1 12 0
0 3 0
17 7 1
5 7 1
16 18 1
18 4 1
1 3 1
13 2 2
15 0 2
14 6 2
5 6 2
