width 20
height 20
..@@.@.@....@.@.@...
.@.......@.@......@.
..@@@@.@..@.@.@@.@@@
@..@@.@.@.......@@@@
..@......@.@@.@...@@
@.@@@.@.@@..@@..@@@@
@..@@.@....@@@@.@@@@
..@....@@.@@@@@@@@@@
.@..@@.@..@@@@@@@@@@
...@@@@@@.@@@@@@@@@@
.@.@@@@@@@.@@@@@@@@@
@@...@@@@@..@@@@@@@@
@..@@@@@@..@.@@@@@@@
@@..@@@@@@...@@@@.@.
@@.@.@@.@.@@..@@@...
@............@....@.
..@.@.@.@.@.@..@@.@.
@..@@@@..@@..@@@...@
..@@@@@@@...@.@.@.@@
@...@@@@@.@.........
6
2 10 0
2 14 0
5 6 1
9 18 1
14 16 2
17 4 2

2 15 0
18 19 0
5 4 1
0 1 1
18 0 2
2 9 2
