width 20
height 20
@@@@@@@@@@@@@@.@@.@@
@@@@@@@@@@@@...@@.@.
@@@@@@@@@@@@@@....@.
@@@@@@@@@@@..@@.@...
@@@@@@@@@@..@.@..@.@
@@@@@@@@@@@....@..@@
@@@.@@@@@@@.@@...@@@
..@..@@@@@.@@..@..@@
.@..@..@.@.@.@..@@@@
...@.@.@.......@@@@@
@@.....@@@.@.@..@@@@
@..@.@.@....@.@..@@@
..@@@@@@.@.@...@.@@@
@..@.@.@..@@@.@...@@
@@.@.....@......@@@@
.....@.@@.@.@@.@.@@@
.@.@.@@......@....@@
@...@@..@.@.@@@.@.@@
@@.@@.@..@...@@@...@
@......@.@.@@@@..@..
6
8 12 0
18 4 0
17 7 1
15 6 1
0 8 2
9 11 2

6 14 0
15 3 0
4 13 1
2 19 1
8 14 2
7 18 2
