width 20
height 20
@@@@@@@@.@..@@@@@@@@
@@@@@@.....@.@@@@@@@
@@@@@@@.@@...@@@@@@@
@@@@@@@@@@@@..@@@@@@
@@@@@@@@@@@@.@@@@@@@
@@@@@@@@@@@...@@@@@@
@@@@@@@@@@@@.@@@.@@@
@@@@@@@@@@@...@...@@
@@@@@@@@@@@@.@@.@.@@
@@@@@@@@@@@..@...@.@
@@@@@@@@@@@@..@.@..@
@@@@@@@@..@.@.....@.
@@@@@@@@@.....@.@...
@@@@@@@@@@.@.@..@@@.
@@@@@@@@@@.@@@.@@.@.
@@@@@@@@@@@@@@.@..@.
@@@@@@@@@@@@@...@...
@@@@@@@@@@@@@@@@..@.
@@@@@@@@@@@@@@...@..
@@@@@@@@@@@@@@.@..@.
6
14 19 0
15 11 0
19 18 1
18 9 1
16 19 2
10 2 2

12 5 0
13 7 0
10 1 1
16 17 1
19 17 2
13 11 2
