width 20
height 20
......@..........@..
....................
....@@..............
.........@..@.......
.............@..@...
@.....@....@...@....
@..@...........@....
......@............@
....@......@.@...@.@
...................@
..@..@....@.@..@....
..@.@.@.............
..@......@..........
....................
@..................@
@@..@....@......@@@@
...............@@@@@
...@...@.....@@@@@@@
..........@@@@@@@@@@
..@.......@@@@@@@@@@
1
2 13 0

13 9 0
