width 20
height 20
...@@........@....@@
@...@@.......@....@@
............@@....@.
....................
.......@..@.........
..............@...@.
.........@..........
..........@.........
.....@.....@........
...............@....
.@.......@..........
.....@@.......@..@..
.....@@.............
....................
.@.....@............
............@.......
.........@.....@....
.......@....@....@..
......@@............
..@.@...............
1
1 4 0

13 5 0
