width 20
height 20
@@@@@@@@@.@...@@@@@@
@@@@@@@@@...@..@@@@@
@@@@@@@@@@.@..@@@@@@
@@@@@@@@@@@.@.@@@@@@
@@@@@@@@@@.....@@@@@
@@@@@@@@@@.@.@..@@@@
@@@@@@@@@..@@@@..@.@
@@@@@@@@@.@.....@...
@@@@@@@@..@.@.@@..@.
@@@@@@@..@@@@@..@..@
@@@@@@@@.@@.@.@...@@
@@@.@@@@.@......@.@@
@@..@@@....@@.@.@@@@
@.@.@.@.@@...@@.@.@.
@......@.@@@.@@.....
@@.@.@....@@@..@@.@.
....@@@@.@.@.@.@.@@.
@.@@@@@.............
..@@@@@@.@@.@.@.@.@.
@..@@@@@@@@.@..@...@
6
2 16 0
7 13 0
8 14 0
10 16 0
9 0 0
17 15 0

13 1 0
18 17 0
16 14 0
13 2 0
10 1 0
15 11 0
