width 20
height 20
@@@@@@@@@@@@@@@@@@@@
@@@@@@.@@@@@@@@@@@@@
@@@@@@..@@@@@@@@@@@@
@@@@@@@.@@@..@@@@@@@
@@@@@@@..@.@..@@@@@@
@@@@@@.@.....@@@@@@@
@@@@@@...@@@..@@@@@@
@@@@@..@@@@@.@@@@@@@
@@@@.@..@@@@@@@@@@@@
@....@.@@@.@@@@@@@@@
@@.@....@..@@@@@@@@@
@@@.@.@@.@..@@@@@@@@
@@@........@@..@@@@@
@@@.@.@.@.@.@.@@..@@
@@@..@..@.@....@@..@
@@@.@.@@@.@.@.@@@.@@
@@.....@.@...@@...@@
...@@@.....@@.@@.@@@
@@@@@@@.@@.......@@@
@@@@@@....@@.@.@.@@@
7
13 12 0
12 5 0
5 12 0
7 4 0
2 9 0
10 18 0
3 15 0

10 17 0
8 5 0
17 15 0
13 12 0
10 4 0
9 14 0
8 16 0
