width 20
height 20
@@@@@@@@@.@.....@@@@
@@@@@@@@@...@@@...@@
@@@@@@@@@.@@..@.@@@@
@@@@@@@@@...@...@@@@
@@@@@@@@@@@.@@.@@@@@
@@@@@@@@@@@.@.@..@@@
@@@@@@@@@@@.....@.@@
@@@@@@@@@@@.@.@@...@
@@@@@@@@@@..@..@.@..
@@@@@@@@@@@@.@.@.@@@
@@@@@@@@@@.@.@......
@@@@@@@@@@.....@.@.@
@@@@@@@@@@@.@@.@@..@
@@@@@@@@@@...@...@@.
@@@@@@@@@@@.@@@@....
@@@@@@@@@@@..@@@@@.@
@@@@@@@@@.@.@.@@...@
@@@@@@@@.......@@@.@
@@@@@@@@@.@.@.@....@
@@@@@@@@@@..@@..@.@@
7
19 14 0
9 2 0
10 1 0
13 8 0
14 11 0
9 0 0
19 10 0

11 1 0
10 1 0
11 18 0
12 11 0
9 16 0
16 1 0
15 13 0
