width 20
height 20
........@@......@@@@
............@...@@@@
.@...............@@@
....@.............@@
.......@............
...@......@..@...@..
@...................
@..@.@@.........@...
..........@.@.......
..@.............@...
..............@.@...
..@....@............
....................
......@.....@.......
........@...........
....@........@..@...
..............@....@
.@.....@..@........@
...................@
.......@@.....@.....
15
13 14 0
17 18 0
12 17 0
12 10 0
3 9 0
17 19 1
11 0 1
12 14 1
7 12 1
4 9 1
14 2 2
5 13 2
5 9 2
5 5 2
4 7 2

15 1 0
17 18 0
17 19 0
2 2 0
6 15 0
0 0 1
0 19 1
19 5 1
4 1 1
16 19 1
14 0 2
10 1 2
5 9 2
5 16 2
13 4 2
