width 20
height 20
@@...............@@.
@...@...............
@.........@......@..
@...@....@..........
......@......@......
...@......@.........
................@...
............@.....@.
...@......@..@.@....
....................
..........@....@..@.
..@.................
...........@........
....@.@......@...@..
.....@..........@...
.............@...@..
..@..@@..@..@.......
..................@.
..@.....@........@..
....................
1
7 7 0

15 0 0
