width 20
height 20
@@@@@@..............
@@@@@@...@..@.......
....................
........@...........
.................@..
....................
@...................
@..@@....@..........
.............@.@....
..........@.@.......
.....@..............
.......@......@.....
.....@..............
...@.@...@..@.....@.
....................
.........@..........
...............@....
....@.....@.@.......
..................@.
....................
1
8 7 0

8 2 0
