width 20
height 20
..............@.....
....@.......@.......
.....@.@...........@
.....@.............@
.......@............
..@.................
...............@....
........@.........@.
.......@.@......@...
...............@....
.@.@......@.@.......
....................
@.............@....@
....................
...@..@.............
....................
.........@@.........
..........@.........
.......@..@.@@@..@@@
........@@@.@@@.@@@@
1
8 18 0

18 16 0
