width 20
height 20
...................@
.......@.....@....@.
....................
.......@......@@....
...@........@......@
........@.........@@
...@...............@
...................@
.......@....@.......
..........@...@.@...
....@...............
.@...............@@.
......@...@.........
....................
......@.........@.@.
............@.......
@@...@..............
................@...
.........@..........
.....@..@@@.........
1
17 4 0

15 19 0
