width 20
height 20
...@........@.....@@
............@...@...
.............@....@@
...@....@.........@@
.....@......@....@..
..@.@.@.............
...................@
@.....@.............
.............@......
.@.@..@.....@.......
...@.....@.........@
.@......@..@..@.....
...@................
......@...@..@......
........@...........
....@...............
..............@.....
..........@....@....
..@.@@.............@
....@@@............@
1
1 16 0

18 13 0
