width 20
height 20
..........@.........
.....@..............
....................
.................@..
..@@................
..@@........@.......
.@........@..@......
....@............@..
.........@..........
......@.....@.@...@.
..@..@..............
...@......@.......@.
................@...
.@....@...@.........
...@...........@....
..........@...@.....
....................
....@........@..@...
....................
...............@....
13
5 13 0
16 0 0
6 17 0
7 18 0
5 0 0
17 13 0
13 0 0
1 4 0
1 19 0
14 10 0
11 18 0
12 15 0
10 17 0

1 14 0
15 12 0
19 2 0
8 11 0
6 4 0
5 16 0
1 2 0
17 13 0
2 16 0
1 3 0
9 13 0
1 0 0
13 3 0
