width 20
height 20
......@............@
..............@....@
....@.@............@
..@....@..@......@..
..........@..@......
............@@.@....
....................
.........@..........
....@......@........
@@.....@............
@..........@..@...@.
....@.....@..@......
..@..@.........@....
....................
....@.......@.......
........@...........
...............@.@..
...........@.@......
@..@................
@....@..............
13
5 7 0
0 11 0
13 2 0
14 2 0
10 18 0
11 4 0
19 6 0
9 16 0
14 19 0
13 8 0
11 18 0
4 6 0
18 9 0

4 6 0
17 12 0
2 10 0
13 1 0
11 15 0
19 19 0
18 15 0
19 15 0
10 18 0
10 8 0
11 0 0
4 7 0
7 8 0
