width 20
height 20
...............@@@@@
..............@@@@@@
...............@@@@@
@............@......
....................
....@........@......
......@.............
........@........@..
.............@......
....................
........@.......@...
......@.....@....@..
@........@..........
............@.......
....................
.....@..@...........
.........@..........
...@........@.......
....................
....................
8
5 18 0
18 5 0
10 14 0
1 9 1
2 5 1
10 12 1
4 18 2
1 7 2

6 18 0
4 19 0
1 7 0
16 19 1
15 15 1
5 12 1
5 13 2
2 11 2
