width 20
height 20
...............@...@
@......@............
..................@@
.......@..........@@
......@..........@@@
........@.........@@
..@...@........@..@@
........@...@.....@@
...@.@..........@...
.........@..........
....@...@...........
..........@......@..
@......@............
@...@.......@...@...
.....@............@.
..@....@........@...
........@...........
..............@..@..
.......@............
....................
8
0 6 0
13 0 0
16 16 0
13 14 1
17 7 1
1 1 1
0 14 2
13 2 2

10 10 0
19 18 0
0 17 0
2 1 1
5 18 1
12 19 1
12 0 2
13 2 2
