width 20
height 20
@@@...@............@
@@@@.@.@.@.@.@.@.@@@
@........@..@.@@.@..
..@@@.@.@@.@@.@.@.@.
@@@..@.@.@..@.......
@@..@......@..@.@.@@
@@@...@.@@@@@@.@..@@
@@@@@..@@.@@...@.@.@
@@@@@@.......@......
@@@@@@@.@.@.@..@.@@@
@@@@@@@@@@@@@@@....@
@@@@@@@@@@@....@.@@@
@@@@@@@@@@..@@@@...@
@@@@@@@@@.@..@@..@..
@@@@@@@@@.@.@..@.@@@
@@@@@@@@@.....@...@@
@@@@@@@@..@.@.@.@.@.
@@@@@@@@@.@.@...@...
@@@@@@@@@@@@@@@..@@@
@@@@@@@@@@@@@@..@@@@
16
11 0 0
16 1 0
2 2 0
17 16 0
13 4 0
8 1 0
19 8 1
13 9 1
9 15 1
19 3 1
19 4 1
16 12 2
10 5 2
13 17 2
2 5 2
4 1 2

12 15 0
14 7 0
9 5 0
6 1 0
13 7 0
7 6 0
18 2 1
14 9 1
10 1 1
9 0 1
0 3 1
19 2 2
11 15 2
7 2 2
8 1 2
10 0 2
