width 20
height 20
@@@@@......@....@...
@@@@@.@@.@...@.@..@.
@@@@@@@@@@@@.@.@.@..
@@@@@@@@@@@.@..@.@.@
@@@@@@@@@.@.@@....@.
@@@@@@@@.....@.@.@..
@@@@@@@..@@.@..@..@.
@@@@@..@@.@.@@.@@...
@@@@..@.@....@@...@.
@@@.@.....@@@@@@.@.@
@@....@@.@.........@
@.@.@...@@@.@.@.@@..
...@..@..@.@.@.@.@.@
@.@.@..@............
......@@@.@@.@.@.@.@
@.@@.@@@....@.@.@...
..@..@@@@@.@..@.@@.@
@@@@.@@@....@....@.@
@@@@@@@@.@.@@.@@....
@@@@@@@@@..@...@@@.@
13
10 10 0
11 11 0
13 18 0
4 12 0
7 0 0
11 3 1
16 1 1
12 13 1
6 0 1
16 17 2
2 10 2
14 0 2
8 9 2

10 1 0
11 6 0
17 18 0
10 16 0
15 8 0
10 17 1
11 10 1
19 2 1
11 1 1
15 15 2
2 10 2
18 13 2
17 13 2
