width 20
height 20
@@@@@@@....@....@@..
@@@@@@@@.@..@@@..@.@
@@@@@@.@@@@.....@..@
@@@@@...@.@.@.@@.@.@
@..@@@@......@@.....
..@.@...@.@.@..@.@@@
@....@.@.@...@....@.
@@.@.....@@.@..@.@..
@...@@@@..@...@.@.@.
@@.@.@@..@@.@.....@.
@@.....@@.@..@@.@...
@@@.@.@@..@.@@@@.@.@
@@@@..@.@.@.@.@....@
@@@@@@....@@...@.@.@
@@@.@.@.@.@..@@...@@
@@.......@@@..@@@...
@@@.@.@@@.@.@.@...@@
@@...@@.@.......@...
@.@.@.@...@.@.@@@@.@
........@..@@@@@@@@@
13
3 18 0
19 17 0
6 13 0
1 18 0
0 19 0
17 2 1
14 0 1
8 9 1
2 9 1
15 16 2
8 18 2
9 8 2
4 10 2

19 10 0
9 8 0
2 6 0
17 8 0
15 4 0
13 16 1
4 10 1
7 18 1
14 9 1
3 5 2
11 17 2
15 14 2
5 19 2
