width 20
height 20
@@@@................
@..............@....
........@.......@...
@...................
@@@.................
@@@@..@......@...@..
@@@@...@............
...@......@......@..
.......@...@........
...............@..@.
..@....@............
.........@..........
..........@.........
......@....@........
............@..@...@
...................@
...@................
.................@..
.....@......@.......
...............@@...
9
18 1 0
11 16 0
19 7 0
4 4 0
13 19 0
4 8 0
9 3 0
7 11 0
12 2 0

1 19 0
7 18 0
13 10 0
1 7 0
9 18 0
3 8 0
17 18 0
13 18 0
9 3 0
