width 20
height 20
@@..................
@...@@.......@......
@..................@
......@..@.@......@@
....................
.......@..@.........
............@.......
....................
...@...@.@..........
..@...........@.@...
.................@..
.......@...@........
.....@..@...@@......
....@.......@@......
...@...@.....@.@....
....@@..............
..........@.....@...
.....@..............
...........@..@@....
..............@@....
9
16 15 0
12 14 0
18 12 0
6 10 0
4 4 0
13 11 0
17 19 0
15 17 0
9 1 0

7 3 0
18 17 0
2 3 0
13 5 0
10 17 0
7 10 0
5 14 0
2 16 0
15 15 0
