width 20
height 20
@@@@@..@.@.@@@@@@@@@
@@@@..@@.@.@@@@@.@.@
@@@@@....@...@@.....
@@@@@.@.@..@....@.@.
@@@@@@....@..@.@@@@@
@@@@@@@.@.@.@.@@@@@@
@@@@@@.@...@...@.@@@
@@@@@@...@@@.@....@@
@@@@@.@@.@@.@..@.@@@
@@@@........@.@...@@
@@@.@.@@.@@....@.@@@
@@.....@@...@.@..@@@
@@.@.@..@@.@@.@.@@@@
@...@.@@..@.@@@..@@@
@@@...@..@..@@@.@@@@
@@@@@.@.@@.@@@@@@@@@
@@@@.......@@@@@@@@@
@@@@.@.@.@@@@@@@@@@@
@@@@@@.@...@@@@@@@@@
@@@@@@@..@@@@@@@@@@@
11
9 9 0
6 4 0
9 18 0
8 1 0
7 14 0
13 8 0
11 11 0
2 11 0
8 6 0
14 4 0
11 10 0

3 14 0
10 16 0
8 9 0
8 1 0
16 7 0
9 4 0
8 10 0
15 14 0
14 10 0
17 9 0
9 9 0
