width 20
height 20
@@@@@@@@@@........@@
@@@@@@@@@.@@@.@.@@@@
@@@@@@@@......@....@
@@@@@@@@.@.@@@.@@@@@
@@@@@@@@@@..@...@.@@
@@@@@@@@@..@.@.@....
@@@@@@@@@@.......@@.
@@@@@@@@@..@@.@.@...
@@@@@@@@@@@@.@@@..@.
@@@@@@@@@@@......@.@
@@@@@@@@@@@@@@.@...@
@@@@@@@@@.@.....@@..
@@@@@@@@....@@.@@@@.
@@@@@@@..@.@...@@@@@
@@@@@@.@..@.@.@@@@@@
@@@@@....@@...@@@@@@
@@@@@.@@..@.@@@@@@@@
@@@@@@@..@@@@@@@@@@@
@@@@@@@@..@@@@@@@@@@
@@@@@@@@@@@@@@@@@@@@
11
11 16 0
13 9 0
19 12 0
10 13 0
18 5 0
15 4 0
10 3 0
13 6 0
15 9 0
10 5 0
18 9 0

9 2 0
12 6 0
17 7 0
11 11 0
13 0 0
10 2 0
17 8 0
19 8 0
10 4 0
9 14 0
15 6 0
