width 20
height 20
.@.@@@..............
....@@......@.......
..@.........@@.@....
....................
....................
.........@..........
.........@....@.....
.....@.@@@@.........
@.@.@...............
@...................
......@@.......@@...
......@@....@..@@..@
......@@...........@
...@................
...........@........
@.....@.@....@......
@..................@
.........@..........
.....@......@.......
@..@@@.....@@.......
13
1 1 0
5 15 0
7 8 0
15 5 0
8 13 0
7 3 1
11 3 1
0 17 1
2 19 1
17 19 2
2 1 2
6 19 2
18 10 2

18 17 0
14 4 0
18 8 0
3 7 0
11 6 0
2 4 1
7 3 1
19 0 1
2 19 1
2 7 2
19 8 2
19 1 2
12 0 2
