width 20
height 20
....................
......@............@
.@..@.........@....@
...............@@..@
..@................@
.......@...@........
...........@........
.........@.@........
.......@............
...@....@...@.@....@
@@.................@
@@.@.@....@.........
@@................@.
@...................
.....@.......@......
................@...
..@..@....@.........
....@......@..@.....
.........@........@.
...........@........
13
15 13 0
10 8 0
6 0 0
8 18 0
7 9 0
12 1 1
3 16 1
17 12 1
11 13 1
16 19 2
0 18 2
12 8 2
12 0 2

19 19 0
7 7 0
14 8 0
2 3 0
7 9 0
5 8 1
9 9 1
12 3 1
2 1 1
2 2 2
7 13 2
0 15 2
7 11 2
