width 20
height 20
.................@..
..@.................
.........@.....@....
........@...........
....................
...@..@.@...........
...................@
....................
..@..........@......
......@.@.@.........
...@................
.......@............
....................
...@.@........@.@...
....................
..........@.@.......
.@..............@...
.......@............
......@.............
....................
15
1 12 0
10 0 0
4 6 0
2 9 0
4 3 0
12 9 1
5 0 1
17 1 1
1 1 1
10 7 1
15 18 2
5 1 2
0 3 2
17 4 2
6 17 2

7 13 0
0 1 0
4 11 0
19 18 0
9 15 0
3 18 1
13 17 1
10 7 1
13 18 1
17 17 1
6 1 2
17 18 2
0 2 2
17 4 2
7 18 2
