width 20
height 20
..................@@
@.............@...@@
....@.......@......@
..........@......@.@
................@..@
.........@.........@
....................
...@................
@.@...........@...@@
.....@...@@.........
.....@...@.......@..
.............@@.....
.......@..........@.
...............@..@.
.@....@..@....@.....
....................
......@..@..........
...........@........
....@...............
....................
15
16 7 0
2 15 0
2 10 0
3 10 0
15 10 0
13 10 1
9 8 1
19 11 1
11 11 1
4 17 1
13 3 2
4 5 2
9 0 2
15 1 2
9 3 2

11 0 0
16 1 0
2 16 0
11 10 0
1 19 0
1 3 1
7 14 1
4 1 1
4 17 1
6 11 1
19 18 2
5 2 2
8 1 2
2 7 2
19 19 2
