width 20
height 20
@..@................
@.........@...@...@.
....................
....................
......@...@@........
........@....@..@...
@...................
...@.@.........@....
............@.......
..............@@@..@
.........@@...@@@...
......@.............
......@.....@@@.....
......@.............
..@...@.............
....................
................@@@@
.@..............@@@@
..........@......@@@
@.........@......@@@
6
11 19 0
4 7 0
18 3 1
18 8 1
1 8 2
3 14 2

2 0 0
4 7 0
4 15 1
18 12 1
7 19 2
5 9 2
