width 20
height 20
....@@@.........@@@@
....@...........@@@@
........@.....@@@@@@
......@.......@@@@@@
...@...........@@@@@
...@....@......@@@@@
...............@@@@@
....@..@.@.....@@@@@
................@@@.
.@........@.........
.......@...........@
...@...........@....
.@...@..............
....@..@........@...
..@................@
........@.....@...@@
.......@..@.@.....@@
...................@
..............@.....
....................
6
0 15 0
17 12 0
0 0 1
2 3 1
1 6 2
14 8 2

0 15 0
1 2 0
10 8 1
13 0 1
18 17 2
2 11 2
