width 20
height 20
@.....@@.......@@@..
@..............@@@..
.................@..
..........@........@
...........@..@.....
.....@..@..@@....@..
................@...
.....@..@.........@.
........@...@.......
....@...............
...............@.@..
.@.....@............
...@......@.....@...
......@.....@....@..
..@.....@.....@.....
.@.@................
......@@....@.@.....
..........@..@...@@@
.................@@@
@@@.............@@@@
6
9 7 0
14 8 0
9 12 1
4 0 1
10 5 2
2 8 2

8 2 0
18 14 0
12 17 1
18 15 1
13 18 2
19 4 2
