width 20
height 20
@@...@........@@@@@@
@@..@@....@.@.@@....
....................
..........@...@.@...
......@.............
....................
..................@.
.............@...@..
..@..@...@..........
....................
............@.....@.
....................
..@.....@........@..
....@.........@.@..@
....................
........@.......@...
..@....@...@..@.@...
....................
.....@..............
@@...............@@.
14
2 19 0
9 19 0
10 7 0
19 10 0
9 11 0
17 11 0
1 2 0
6 10 0
4 18 0
14 6 0
13 3 0
6 18 0
14 8 0
7 9 0

19 1 0
8 10 0
4 4 0
15 3 0
0 2 0
1 6 0
3 19 0
18 12 0
2 19 0
14 7 0
13 4 0
11 4 0
3 16 0
7 9 0
