width 20
height 20
..@@@@@@.@@@@@@@@@@@
.@@@@@@@.@@@@@@@@@@@
..@@@.@....@@@@@@@@@
.@.@..@.@@@@@@@@@@@@
...@.@@..@@@@@@@@@@@
.@....@.@@@@@@@@@@@@
..@.@.@.@@@@@@@@@@@@
.@.@.....@@@@@@@@@.@
@@.@@.@@..@@@@@@@..@
@.....@@.@.@.@@@@@.@
@@.@@@@.@...........
...@@.@..@.@@.@.@.@.
@@.....@..@@@@@..@..
@@@.@@.@.@.@@.@.@.@.
@@@@..........@....@
@@@..@.@@.@.@@.@@.@@
@@.@..@@..@.......@@
...@.@...@..@@.@.@@@
@@.@..@@..@@....@@@@
.....@@@@@@@@.@@@@@@
11
2 17 0
18 7 0
7 11 0
6 13 0
16 16 0
3 6 0
14 15 0
0 7 0
18 8 0
19 10 0
5 9 0

16 16 0
17 10 0
13 13 0
6 12 0
0 17 0
18 14 0
8 17 0
15 12 0
4 5 0
0 19 0
17 16 0
