width 20
height 20
@@@@@@@@@..@@@@.@@@@
@@@@@@@.@.@@@@@...@@
@@@@@@.....@@.@.@@@@
@@@@@.@.@@@.......@@
@@@@......@@@@@@.@@@
@@@@.@.@@@@.@@....@@
@@@@..@@@@.....@@@@@
@@.@.@..@.@.@.@@@@@@
@......@@....@@@@@@@
@@.@.@....@.@@@@@@@@
@@..@@@@@..@@@.@@@.@
...@@..@.@@.@@.@...@
@.@@.@...@......@@..
.......@@.@.@@.@@@.@
@.@@.@.......@..@@..
@@@.@@.@@.@.@..@@..@
......@..@@.@@...@.@
.@.@@.@.@....@.@...@
..@@......@.@@@..@@@
.@@@@.@.@..@@@@@.@@@
11
11 9 0
3 8 0
7 19 0
12 12 0
17 15 0
13 12 0
4 14 0
3 15 0
4 8 0
4 9 0
17 3 0

17 15 0
6 9 0
4 16 0
17 1 0
11 15 0
15 16 0
15 18 0
5 17 0
4 9 0
1 11 0
18 12 0
