width 20
height 20
....................
......@............@
.@.............@...@
...................@
....@....@.......@..
....................
............@.....@.
...@.@..@.....@@....
....................
....@.@.@.........@.
..........@...@...@@
.....@.....@......@@
..@............@...@
..........@.......@@
.....@.............@
....................
..@.....@..@.....@..
...@.....@.....@....
@@...........@......
@..........@........
9
5 4 0
19 5 0
3 19 0
19 7 1
5 3 1
0 14 1
5 5 2
16 13 2
7 18 2

18 8 0
19 5 0
6 11 0
18 7 1
0 1 1
14 0 1
5 12 2
3 2 2
18 5 2
