width 20
height 20
....................
...........@........
.@.....@............
.......@............
....@........@.@....
@.......@...........
.................@..
.......@............
...@@@....@.@..@....
...@@@.............@
..@......@..@.......
...............@....
@.....@....@........
.............@.@..@@
.........@.@........
....................
............@.@.@...
....................
@...@@..............
@...@.........@.....
9
2 2 0
0 14 0
14 5 0
7 10 1
10 19 1
11 9 1
3 7 2
11 8 2
7 19 2

2 12 0
3 15 0
19 18 0
18 0 1
0 0 1
14 15 1
11 19 2
7 12 2
18 1 2
