width 20
height 20
..@@................
....................
.................@..
........@.......@...
@...........@.......
@...................
.@....@........@....
.....@.....@........
.........@.......@..
...@................
.@.............@....
..@...........@....@
..........@.@.......
......@.@.........@.
.........@..........
..@...@.....@.......
................@...
........@...........
...................@
............@.......
9
9 19 0
9 13 0
4 11 0
13 16 1
7 9 1
12 11 1
12 13 2
8 7 2
18 19 2

12 5 0
6 2 0
19 0 0
15 18 1
7 9 1
0 1 1
14 13 2
4 9 2
16 9 2
