width 20
height 20
@@@................@
@@.............@...@
....@...@.......@.@.
..@.......@.@.......
...............@....
....................
......@....@...@....
.....@............@.
....................
.....@.......@......
.......@............
..@......@..@...@...
...........@........
.....@..........@...
...........@........
...............@....
.........@..@.......
..................@@
.....@......@@@.@.@@
..@..........@@...@@
1
15 3 0

9 17 0
