width 20
height 20
.................@@@
...@..............@@
............@.......
..@..@..............
............@.......
..@...@....@........
.........@.....@....
....@...............
.....@..........@...
......@..@...@.@....
.....@.@............
..@.................
.........@......@...
.............@@.....
....................
....@...@...........
.....@....@.@.....@.
..............@.....
..@.....@...........
.@@.................
18
8 13 0
15 3 0
9 3 0
17 15 0
14 19 0
10 13 0
11 6 1
17 19 1
7 14 1
19 11 1
1 3 1
12 0 1
12 7 2
16 19 2
7 7 2
16 14 2
3 2 2
18 5 2

16 1 0
9 19 0
5 6 0
11 17 0
5 18 0
2 12 0
0 18 1
14 5 1
17 12 1
10 3 1
10 7 1
6 17 1
11 2 2
0 13 2
7 7 2
1 0 2
4 17 2
4 11 2
