width 20
height 20
@@@@@@@@@@@@@@......
@.@@@@@@@@@@@@@.@@@.
@.@.@@@@.@.@@.@@.@@.
@....@@....@........
@@@.@...@.@.@.@.@.@@
@@....@@....@.@.@...
@.@.@.@@@.@...@@.@.@
.....@@@@@@@.@....@@
@@.@..@@@@@....@.@.@
@@@@.@@@@@@@@.@@@...
@@@...@@@.@@@@.@..@.
@@@@.@....@@@@.@@..@
@@@...@@@...@.....@.
@@@@.@@.@.@..@@.@...
@@@@.......@.@.@..@.
@@@..@.@.@@@@..@@.@@
@@@@@@@..@.@.@.@....
@@@@@@@@.......@.@@@
@@@@@@@@@@@@.@......
@@@@@@@@@@@@@..@.@@.
7
4 10 0
17 9 0
17 0 0
15 18 1
8 3 1
14 11 2
19 2 2

16 0 0
3 5 0
12 6 0
13 17 1
8 11 1
17 18 2
17 13 2
