width 20
height 20
@.@.....@..@..@..@.@
@...@.@.@.@..@@@...@
.@.@@@......@.@.@@..
...@@@@@.@.@@......@
@.@.@@@.@@@@..@.@.@@
@.@..@@..@.@@..@@@@@
..@.@..@......@.@.@@
@.....@@.@.@@.@.....
@@.@@..@.@...@@@@@.@
.@@@..@..@@@@@@@.@.@
.@.@@.@.@.@..@@@.@..
......@.....@.@....@
@@@.@...@.@....@.@.@
@@@.@@.@..@@.@....@@
@@....@.@@@@@@.@.@@@
@.@.@...@@@@@@@@..@@
...@.@.@@@@@@....@.@
@@...@.@@@@@@@.@....
.@.@...@@@@@.@.@@@.@
....@@..@@@@....@@@@
8
5 1 0
3 15 0
14 19 0
11 2 1
8 13 1
17 7 1
9 0 2
18 18 2

16 1 0
10 8 0
5 12 0
15 6 1
10 0 1
16 16 1
6 15 2
18 17 2
