width 20
height 20
@@@@@@@@.@.@.@@@@@@@
@@@@@@@@.....@@@@@@@
@@.@@@@@.@.@...@@@@@
@.....@@@@.@@.@@@@@@
.@@.@@@@.@@.@.@@@@@@
..............@@@@@@
.@.@.@@@.@@.@@.@@@@@
..@.@....@@.@@.@@@@@
@@....@.@@@@.....@@@
.@@.@.@..@.@.@.@.@@@
....@@.@.....@.@..@@
@@@....@@.@.@@@..@.@
@.@.@.@@..@@.@.@....
..@.@@...@.@.....@@@
@....@@@@..@.@.@...@
..@.@@@@.@....@@@.@.
.@.@@.@..@.@.@@@....
...@....@..@@@@@@.@.
@.@..@.@.@..@@@@@..@
@@@@@......@@@@@@@..
8
9 1 0
14 2 0
6 10 0
9 10 1
12 10 1
12 2 1
12 12 2
17 17 2

8 1 0
3 14 0
10 3 0
4 8 1
8 12 1
13 2 1
8 16 2
15 13 2
