width 20
height 20
@@@@@@@@@..@.@.@.@@@
@@@@@@@@@@........@@
@@@@@@@@@@@@.@.@.@@@
@.@@@.@@@@@@@..@.@@@
...@...@@.@@.@..@.@.
@.@.@.@.@.@...@.....
@...........@.@.@.@.
@@@@@.@@.@.@...@..@.
@@@@@@....@.@.@.@..@
@@@@@@@@@.@.@.....@@
@@@@@@..@....@.@.@@@
@@@@@@@..@@.@@@@@@@@
@@@@@@@@.....@@@@@@@
@@@@@@@@@.@.@@@@@@@@
@@@@@@@@@@...@@.@@@@
@@@@@@@@@@@@.@@.@@@@
@@@@@@@@@@@@.....@@@
@@@@@@@@@@@@@@@.@@@@
@@@@@@@@@@@@@@@@@@@@
@@@@@@@@@@@@@@@@@@@@
2
6 10 0
15 5 1

17 8 0
16 16 1
