width 20
height 20
@@@@@@@@@@@@@@@@@@@@
@@@@@@@.@@@@@@@@@@@@
@@@@@@..@@@@@@@@@@@@
@@@@@@@..@@@@@@@@@@@
@.@@@.@.@@@@@@@@@@@@
@..@......@@@@@@@@@@
..@.@.@@.@@@@@@@@@@@
@......@@@@@@@@@@@@@
@.@@@@@@@@@@@@@@@@@@
@..@@@@@@@@@@@@@@@@@
@.@@@@@@@@@@@@@@@@@@
...@.@.@@@@@@@@@@@@@
@.@.....@@@@@@@@@@@@
....@@.@@@@@@@@@@@@@
.@.@@@...@@@@@@@@@@@
..@@@@@.@@@@@@@@@@@@
@...@@.....@@@@@@@@@
..@..@@@@.@@@@@@@@@@
@.@.@@@@...@@@@@@@@@
...@@@@@@.@@@@@@@@@@
16
1 5 0
9 5 0
3 12 0
2 13 0
0 19 0
3 17 0
1 7 0
2 5 0
1 17 0
1 19 0
9 18 0
1 8 0
5 12 0
7 16 0
5 5 0
7 5 0

7 16 0
5 12 0
0 17 0
6 11 0
2 7 0
8 16 0
3 16 0
5 5 0
1 10 0
1 19 0
2 5 0
1 8 0
6 7 0
0 13 0
4 12 0
1 7 0
