width 20
height 20
..................@@
............@.......
...............@.@..
........@.@.@.@@....
..@..............@..
....@...............
..................@.
...............@.@..
....................
.........@.@........
@..............@....
......@.....@....@..
....@........@......
........@.@.....@...
.@..................
....................
...............@....
.......@......@.....
..@....@............
....................
11
3 14 0
8 17 0
5 6 0
1 5 0
3 16 1
18 12 1
3 0 1
8 11 1
7 2 2
12 17 2
4 16 2

11 10 0
0 16 0
13 15 0
3 7 0
6 2 1
8 1 1
5 6 1
17 5 1
17 19 2
1 12 2
19 1 2
