width 20
height 20
..@....@@.........@@
.......@@......@..@@
..@................@
..............@.....
.........@..........
@..........@..@.....
....@...............
............@.....@.
...@.....@@@@@......
..@......@@....@.@..
........@....@......
......@.........@...
..........@@........
.@...@...@@@@@@.....
.........@@@@@@.....
@@@...@@@@@@@@@@@...
@@@@@..@@@@@@@@@@@@.
@@@@@@@@@@@@@@@@@@@@
@@@@@@@@@@@@@@@@@@@@
@@@@@@@@@@@@@@@@@@@@
11
16 0 0
14 7 0
19 13 0
9 7 0
4 5 1
0 10 1
14 10 1
0 6 1
19 14 2
11 1 2
2 11 2

6 12 0
4 14 0
17 10 0
18 13 0
5 5 1
15 2 1
1 2 1
0 9 1
16 9 2
7 2 2
3 11 2
