width 20
height 20
..@.................
.....@..............
.....@.......@......
.....@........@.....
..................@.
.......@........@...
.....@.........@....
...@................
.......@..@.........
.@..........@.......
...@...@..@.........
........@.....@.....
................@.@.
...........@........
.....@..........@...
...@.....@.........@
....................
....@......@........
..@............@....
........@@........@@
11
13 16 0
1 0 0
1 12 0
4 19 0
10 7 1
5 15 1
12 12 1
12 18 1
19 3 2
0 15 2
1 2 2

14 19 0
17 19 0
10 5 0
3 4 0
11 7 1
12 19 1
13 11 1
17 15 1
19 16 2
18 14 2
18 16 2
