width 20
height 20
@@@@@@@@.@..@@@@@@@@
@@@@@@@@...@@@@@@@@@
@@@@@@.@.@.@@@@@@@@.
@@@@@....@.@@.@@@@@.
@@@@@.@.@.@.@...@.@.
@......@.....@@...@.
.@.@.@.@.@.@....@...
....@....@@@.@.@..@@
@.@.@@.@..@@..@.@.@@
@@@@@..@.@@..@.....@
@@@@..@@@@@@@@.@.@.@
@@@@@.@@.@@@@...@@@@
@@@@@@...@@@@@.@..@@
@@@@@..@.@@@@..@@..@
@@@@@@.@..@@@@...@..
@@@@@@@..@@@@..@...@
@@@@@@@.@.@@.@..@@@@
@@@@@@.........@@@.@
@@@@@@@@@@.@@@......
@@@@@@@@@...@..@.@.@
13
5 4 0
14 15 0
10 0 0
17 15 0
17 7 0
7 7 0
10 3 0
7 16 0
16 14 0
14 17 0
2 5 0
9 1 0
8 17 0

15 11 0
5 5 0
15 16 0
8 11 0
4 5 0
15 9 0
11 9 0
16 15 0
10 6 0
5 4 0
7 3 0
11 4 0
10 3 0
