width 20
height 20
@@@@@@@.@@.......@@@
@@@@@@@....@.@.@@..@
@@@@@@@.@@.@@.....@.
@@@@@@@.@...@@.@.@..
@@@@@@..@@.@@@@@.@.@
@@@@..@@....@....@..
@@@@@...@.@..@.@...@
@@@.@.@@@@.@.@@@@.@@
@@.....@@@...@.@.@@@
@..@.@@.@@.@@.....@@
@.@@@@........@@@.@@
.......@@@.@.@@@..@@
@.@@@.@.@.@@@.@.@..@
....@@............@@
@.@..@@.@.@.@.@@@@@.
@@..@@@..@.@..@.@.@.
@@@@@@@@.@.@@.....@.
@@@@@@@..@....@.@...
@@@@@@@@.@@.@..@..@.
@@@@@@@@@@@@@@.@@.@@
13
15 12 0
17 16 0
10 2 0
8 13 0
14 0 0
1 14 0
18 4 0
16 13 0
10 15 0
15 17 0
12 15 0
5 5 0
13 2 0

12 10 0
15 13 0
5 5 0
14 13 0
6 10 0
4 14 0
10 1 0
3 11 0
11 13 0
18 5 0
19 16 0
8 5 0
14 5 0
