width 20
height 20
....................
...@@........@..@...
..@@................
@@@@.......@...@....
@@...............@..
@....@.....@.@......
....................
...@..........@.....
.......@............
...@.@..............
.@..@......@.@......
..........@......@..
@.......@...@.@..@..
....@...............
...............@....
....................
.......@.....@....@@
............@......@
....................
...............@....
12
15 4 0
6 5 0
14 13 0
12 1 0
12 15 0
5 19 0
11 8 0
13 8 0
12 4 0
2 11 0
6 2 0
19 14 0

12 6 0
19 19 0
2 0 0
0 1 0
1 2 0
4 19 0
11 9 0
5 19 0
10 3 0
4 16 0
17 0 0
9 12 0
